InternetGatewayDevice.Capabilities.PerformanceDiagnostic.DownloadTransports 	 HTTP	0	xsd:string
InternetGatewayDevice.Capabilities.PerformanceDiagnostic.UploadTransports 	 HTTP	0	xsd:string
InternetGatewayDevice.CaptivePortal.AllowedList 	 undef	1	xsd:string
InternetGatewayDevice.CaptivePortal.CaptivePortalURL 	 undef	1	xsd:string
InternetGatewayDevice.CaptivePortal.Enable 	0	1	xsd:boolean
InternetGatewayDevice.CaptivePortal.Status 	 Disabled	0	xsd:string
InternetGatewayDevice.DeviceConfig.ConfigFile 	 undef	1	xsd:string
InternetGatewayDevice.DeviceConfig.PersistentData 	 undef	1	xsd:string
InternetGatewayDevice.DeviceInfo.Description 	 Internet Router Device	0	xsd:string
InternetGatewayDevice.DeviceInfo.DeviceLog 	 undef	0	xsd:string
InternetGatewayDevice.DeviceInfo.EnabledOptions 	 undef	0	xsd:string
InternetGatewayDevice.DeviceInfo.FirstUseDate 	 0001-01-01T00:00:00Z	0	xsd:dateTime
InternetGatewayDevice.DeviceInfo.HardwareVersion 	 F1744R_10	0	
InternetGatewayDevice.DeviceInfo.Manufacturer 	 SAGEMCOM	0	xsd:string
InternetGatewayDevice.DeviceInfo.ManufacturerOUI 	 8C10D4	0	xsd:string
InternetGatewayDevice.DeviceInfo.ModelName 	 F\@st 2804, v7 rev.3	0	xsd:string
InternetGatewayDevice.DeviceInfo.ModemFirmwareVersion 	 2926dc02	0	xsd:string
InternetGatewayDevice.DeviceInfo.ProductClass 	 IGD	0	xsd:string
InternetGatewayDevice.DeviceInfo.ProvisioningCode 	 RTCM.MRFC	1	
InternetGatewayDevice.DeviceInfo.SerialNumber 	 N7151912G000025	0	xsd:string
InternetGatewayDevice.DeviceInfo.SoftwareVersion 	 F1744R_V1.26_RTC_NU_10	0	
InternetGatewayDevice.DeviceInfo.SpecVersion 	 1.0	0	
InternetGatewayDevice.DeviceInfo.UpTime 	4785	0	xsd:unsignedInt
InternetGatewayDevice.DeviceInfo.VendorConfigFile.1.Date 	 0001-01-01T00:00:00Z	0	xsd:dateTime
InternetGatewayDevice.DeviceInfo.VendorConfigFile.1.Name 	 config.img	0	xsd:string
InternetGatewayDevice.DeviceInfo.VendorConfigFile.1.Version 	 F1744R_V1.26_RTC_NU_10	0	xsd:string
InternetGatewayDevice.DeviceInfo.VendorConfigFileNumberOfEntries 	1	0	xsd:unsignedInt
InternetGatewayDevice.DeviceSummary 	 InternetGatewayDevice:1.1[](Baseline:1,EthernetLAN:1,WiFiLAN:1,WiFiWMM:1,WiFiWPS:1,ADSLWAN:1,ADSL2WAN:1,EthernetWAN:1,QoS:2,Bridging:1,Time:1,CaptivePortal:1,IPPing:1,TraceRoute:1,Download:1,Download...	0	
InternetGatewayDevice.DownloadDiagnostics.BOMTime 	 0001-01-01T00:00:00.000000	0	xsd:dateTime
InternetGatewayDevice.DownloadDiagnostics.DiagnosticsState 	 None	1	xsd:string
InternetGatewayDevice.DownloadDiagnostics.DownloadURL 	 undef	1	xsd:string
InternetGatewayDevice.DownloadDiagnostics.DSCP 	0	1	xsd:unsignedInt
InternetGatewayDevice.DownloadDiagnostics.EOMTime 	 0001-01-01T00:00:00.000000	0	xsd:dateTime
InternetGatewayDevice.DownloadDiagnostics.EthernetPriority 	0	1	xsd:unsignedInt
InternetGatewayDevice.DownloadDiagnostics.Interface 	 undef	1	xsd:string
InternetGatewayDevice.DownloadDiagnostics.ROMTime 	 0001-01-01T00:00:00.000000	0	xsd:dateTime
InternetGatewayDevice.DownloadDiagnostics.TCPOpenRequestTime 	 0001-01-01T00:00:00.000000	0	xsd:dateTime
InternetGatewayDevice.DownloadDiagnostics.TCPOpenResponseTime 	 0001-01-01T00:00:00.000000	0	xsd:dateTime
InternetGatewayDevice.DownloadDiagnostics.TestBytesReceived 	0	0	xsd:unsignedInt
InternetGatewayDevice.DownloadDiagnostics.TotalBytesReceived 	0	0	xsd:unsignedInt
InternetGatewayDevice.IPPingDiagnostics.AverageResponseTime 	0	0	xsd:unsignedInt
InternetGatewayDevice.IPPingDiagnostics.DataBlockSize 	64	1	xsd:unsignedInt
InternetGatewayDevice.IPPingDiagnostics.DiagnosticsState 	 None	1	xsd:string
InternetGatewayDevice.IPPingDiagnostics.DSCP 	0	1	xsd:unsignedInt
InternetGatewayDevice.IPPingDiagnostics.FailureCount 	0	0	xsd:unsignedInt
InternetGatewayDevice.IPPingDiagnostics.Host 	 undef	1	xsd:string
InternetGatewayDevice.IPPingDiagnostics.Interface 	 undef	1	xsd:string
InternetGatewayDevice.IPPingDiagnostics.MaximumResponseTime 	0	0	xsd:unsignedInt
InternetGatewayDevice.IPPingDiagnostics.MinimumResponseTime 	0	0	xsd:unsignedInt
InternetGatewayDevice.IPPingDiagnostics.NumberOfRepetitions 	1	1	xsd:unsignedInt
InternetGatewayDevice.IPPingDiagnostics.SuccessCount 	0	0	xsd:unsignedInt
InternetGatewayDevice.IPPingDiagnostics.Timeout 	1000	1	xsd:unsignedInt
InternetGatewayDevice.LANConfigSecurity.ConfigPassword 	 undef	1	xsd:string
InternetGatewayDevice.LANDevice.1.Hosts.Host.1.Active 	1	0	xsd:boolean
InternetGatewayDevice.LANDevice.1.Hosts.Host.1.AddressSource 	 DHCP	0	xsd:string
InternetGatewayDevice.LANDevice.1.Hosts.Host.1.ClientID 	 0100235471DF68	0	xsd:string
InternetGatewayDevice.LANDevice.1.Hosts.Host.1.HostName 	 Alex_noot	0	xsd:string
InternetGatewayDevice.LANDevice.1.Hosts.Host.1.InterfaceType 	 Ethernet	0	xsd:string
InternetGatewayDevice.LANDevice.1.Hosts.Host.1.IPAddress 	 192.168.1.2	0	xsd:string
InternetGatewayDevice.LANDevice.1.Hosts.Host.1.Layer2Interface 	 InternetGatewayDevice.LANDevice.1.LANEthernetInterfaceConfig.2.,	0	xsd:string
InternetGatewayDevice.LANDevice.1.Hosts.Host.1.LeaseTimeRemaining 	81622	0	xsd:int
InternetGatewayDevice.LANDevice.1.Hosts.Host.1.MACAddress 	 0023.5471.df68	0	xsd:string
InternetGatewayDevice.LANDevice.1.Hosts.Host.1.UserClassID 	 undef	0	xsd:string
InternetGatewayDevice.LANDevice.1.Hosts.Host.1.VendorClassID 	 MSFT 5.0	0	xsd:string
InternetGatewayDevice.LANDevice.1.Hosts.HostNumberOfEntries 	1	0	xsd:unsignedInt
InternetGatewayDevice.LANDevice.1.LANEthernetInterfaceConfig.1.DuplexMode 	 Auto	1	xsd:string
InternetGatewayDevice.LANDevice.1.LANEthernetInterfaceConfig.1.Enable 	1	1	xsd:boolean
InternetGatewayDevice.LANDevice.1.LANEthernetInterfaceConfig.1.MACAddress 	 8C:10:D4:30:FF:79	0	xsd:string
InternetGatewayDevice.LANDevice.1.LANEthernetInterfaceConfig.1.MACAddressControlEnabled 	0	1	xsd:boolean
InternetGatewayDevice.LANDevice.1.LANEthernetInterfaceConfig.1.MaxBitRate 	 Auto	1	xsd:string
InternetGatewayDevice.LANDevice.1.LANEthernetInterfaceConfig.1.Name 	 eth1	0	xsd:string
InternetGatewayDevice.LANDevice.1.LANEthernetInterfaceConfig.1.Stats.BroadcastPacketsReceived 	4098	0	xsd:unsignedInt
InternetGatewayDevice.LANDevice.1.LANEthernetInterfaceConfig.1.Stats.BroadcastPacketsSent 	12	0	xsd:unsignedInt
InternetGatewayDevice.LANDevice.1.LANEthernetInterfaceConfig.1.Stats.BytesReceived 	1422576	0	xsd:unsignedInt
InternetGatewayDevice.LANDevice.1.LANEthernetInterfaceConfig.1.Stats.BytesSent 	104652	0	xsd:unsignedInt
InternetGatewayDevice.LANDevice.1.LANEthernetInterfaceConfig.1.Stats.DiscardPacketsReceived 	3	0	xsd:unsignedInt
InternetGatewayDevice.LANDevice.1.LANEthernetInterfaceConfig.1.Stats.DiscardPacketsSent 	0	0	xsd:unsignedInt
InternetGatewayDevice.LANDevice.1.LANEthernetInterfaceConfig.1.Stats.ErrorsReceived 	0	0	xsd:unsignedInt
InternetGatewayDevice.LANDevice.1.LANEthernetInterfaceConfig.1.Stats.ErrorsSent 	0	0	xsd:unsignedInt
InternetGatewayDevice.LANDevice.1.LANEthernetInterfaceConfig.1.Stats.MulticastPacketsReceived 	8073	0	xsd:unsignedInt
InternetGatewayDevice.LANDevice.1.LANEthernetInterfaceConfig.1.Stats.MulticastPacketsSent 	1	0	xsd:unsignedInt
InternetGatewayDevice.LANDevice.1.LANEthernetInterfaceConfig.1.Stats.PacketsReceived 	13172	0	xsd:unsignedInt
InternetGatewayDevice.LANDevice.1.LANEthernetInterfaceConfig.1.Stats.PacketsSent 	969	0	xsd:unsignedInt
InternetGatewayDevice.LANDevice.1.LANEthernetInterfaceConfig.1.Stats.UnicastPacketsReceived 	1001	0	xsd:unsignedInt
InternetGatewayDevice.LANDevice.1.LANEthernetInterfaceConfig.1.Stats.UnicastPacketsSent 	956	0	xsd:unsignedInt
InternetGatewayDevice.LANDevice.1.LANEthernetInterfaceConfig.1.Stats.UnknownProtoPacketsReceived 	0	0	xsd:unsignedInt
InternetGatewayDevice.LANDevice.1.LANEthernetInterfaceConfig.1.Status 	 Up	0	xsd:string
InternetGatewayDevice.LANDevice.1.LANEthernetInterfaceConfig.2.DuplexMode 	 Auto	1	xsd:string
InternetGatewayDevice.LANDevice.1.LANEthernetInterfaceConfig.2.Enable 	1	1	xsd:boolean
InternetGatewayDevice.LANDevice.1.LANEthernetInterfaceConfig.2.MACAddress 	 8C:10:D4:30:FF:79	0	xsd:string
InternetGatewayDevice.LANDevice.1.LANEthernetInterfaceConfig.2.MACAddressControlEnabled 	0	1	xsd:boolean
InternetGatewayDevice.LANDevice.1.LANEthernetInterfaceConfig.2.MaxBitRate 	 Auto	1	xsd:string
InternetGatewayDevice.LANDevice.1.LANEthernetInterfaceConfig.2.Name 	 eth2	0	xsd:string
InternetGatewayDevice.LANDevice.1.LANEthernetInterfaceConfig.2.Stats.BroadcastPacketsReceived 	84	0	xsd:unsignedInt
InternetGatewayDevice.LANDevice.1.LANEthernetInterfaceConfig.2.Stats.BroadcastPacketsSent 	1	0	xsd:unsignedInt
InternetGatewayDevice.LANDevice.1.LANEthernetInterfaceConfig.2.Stats.BytesReceived 	494640	0	xsd:unsignedInt
InternetGatewayDevice.LANDevice.1.LANEthernetInterfaceConfig.2.Stats.BytesSent 	390636	0	xsd:unsignedInt
InternetGatewayDevice.LANDevice.1.LANEthernetInterfaceConfig.2.Stats.DiscardPacketsReceived 	0	0	xsd:unsignedInt
InternetGatewayDevice.LANDevice.1.LANEthernetInterfaceConfig.2.Stats.DiscardPacketsSent 	0	0	xsd:unsignedInt
InternetGatewayDevice.LANDevice.1.LANEthernetInterfaceConfig.2.Stats.ErrorsReceived 	0	0	xsd:unsignedInt
InternetGatewayDevice.LANDevice.1.LANEthernetInterfaceConfig.2.Stats.ErrorsSent 	0	0	xsd:unsignedInt
InternetGatewayDevice.LANDevice.1.LANEthernetInterfaceConfig.2.Stats.MulticastPacketsReceived 	168	0	xsd:unsignedInt
InternetGatewayDevice.LANDevice.1.LANEthernetInterfaceConfig.2.Stats.MulticastPacketsSent 	101	0	xsd:unsignedInt
InternetGatewayDevice.LANDevice.1.LANEthernetInterfaceConfig.2.Stats.PacketsReceived 	4580	0	xsd:unsignedInt
InternetGatewayDevice.LANDevice.1.LANEthernetInterfaceConfig.2.Stats.PacketsSent 	3617	0	xsd:unsignedInt
InternetGatewayDevice.LANDevice.1.LANEthernetInterfaceConfig.2.Stats.UnicastPacketsReceived 	4328	0	xsd:unsignedInt
InternetGatewayDevice.LANDevice.1.LANEthernetInterfaceConfig.2.Stats.UnicastPacketsSent 	3515	0	xsd:unsignedInt
InternetGatewayDevice.LANDevice.1.LANEthernetInterfaceConfig.2.Stats.UnknownProtoPacketsReceived 	0	0	xsd:unsignedInt
InternetGatewayDevice.LANDevice.1.LANEthernetInterfaceConfig.2.Status 	 Up	0	xsd:string
InternetGatewayDevice.LANDevice.1.LANEthernetInterfaceConfig.3.DuplexMode 	 Auto	1	xsd:string
InternetGatewayDevice.LANDevice.1.LANEthernetInterfaceConfig.3.Enable 	1	1	xsd:string
InternetGatewayDevice.LANDevice.1.LANEthernetInterfaceConfig.3.MACAddress 	 8C:10:D4:30:FF:79	0	xsd:string
InternetGatewayDevice.LANDevice.1.LANEthernetInterfaceConfig.3.MACAddressControlEnabled 	0	1	xsd:string
InternetGatewayDevice.LANDevice.1.LANEthernetInterfaceConfig.3.MaxBitRate 	 Auto	1	xsd:string
InternetGatewayDevice.LANDevice.1.LANEthernetInterfaceConfig.3.Name 	 eth3	0	xsd:string
InternetGatewayDevice.LANDevice.1.LANEthernetInterfaceConfig.3.Stats.BroadcastPacketsReceived 	0	0	xsd:string
InternetGatewayDevice.LANDevice.1.LANEthernetInterfaceConfig.3.Stats.BroadcastPacketsSent 	0	0	xsd:string
InternetGatewayDevice.LANDevice.1.LANEthernetInterfaceConfig.3.Stats.BytesReceived 	0	0	xsd:string
InternetGatewayDevice.LANDevice.1.LANEthernetInterfaceConfig.3.Stats.BytesSent 	0	0	xsd:string
InternetGatewayDevice.LANDevice.1.LANEthernetInterfaceConfig.3.Stats.DiscardPacketsReceived 	0	0	xsd:string
InternetGatewayDevice.LANDevice.1.LANEthernetInterfaceConfig.3.Stats.DiscardPacketsSent 	0	0	xsd:string
InternetGatewayDevice.LANDevice.1.LANEthernetInterfaceConfig.3.Stats.ErrorsReceived 	0	0	xsd:string
InternetGatewayDevice.LANDevice.1.LANEthernetInterfaceConfig.3.Stats.ErrorsSent 	0	0	xsd:string
InternetGatewayDevice.LANDevice.1.LANEthernetInterfaceConfig.3.Stats.MulticastPacketsReceived 	0	0	xsd:string
InternetGatewayDevice.LANDevice.1.LANEthernetInterfaceConfig.3.Stats.MulticastPacketsSent 	0	0	xsd:string
InternetGatewayDevice.LANDevice.1.LANEthernetInterfaceConfig.3.Stats.PacketsReceived 	0	0	xsd:string
InternetGatewayDevice.LANDevice.1.LANEthernetInterfaceConfig.3.Stats.PacketsSent 	0	0	xsd:string
InternetGatewayDevice.LANDevice.1.LANEthernetInterfaceConfig.3.Stats.UnicastPacketsReceived 	0	0	xsd:string
InternetGatewayDevice.LANDevice.1.LANEthernetInterfaceConfig.3.Stats.UnicastPacketsSent 	0	0	xsd:string
InternetGatewayDevice.LANDevice.1.LANEthernetInterfaceConfig.3.Stats.UnknownProtoPacketsReceived 	0	0	xsd:string
InternetGatewayDevice.LANDevice.1.LANEthernetInterfaceConfig.3.Status 	 NoLink	0	xsd:string
InternetGatewayDevice.LANDevice.1.LANEthernetInterfaceConfig.4.DuplexMode 	 Auto	1	xsd:string
InternetGatewayDevice.LANDevice.1.LANEthernetInterfaceConfig.4.Enable 	1	1	xsd:boolean
InternetGatewayDevice.LANDevice.1.LANEthernetInterfaceConfig.4.MACAddress 	 8C:10:D4:30:FF:79	0	xsd:string
InternetGatewayDevice.LANDevice.1.LANEthernetInterfaceConfig.4.MACAddressControlEnabled 	0	1	xsd:boolean
InternetGatewayDevice.LANDevice.1.LANEthernetInterfaceConfig.4.MaxBitRate 	 Auto	1	xsd:string
InternetGatewayDevice.LANDevice.1.LANEthernetInterfaceConfig.4.Name 	 eth4	0	xsd:string
InternetGatewayDevice.LANDevice.1.LANEthernetInterfaceConfig.4.Stats.BroadcastPacketsReceived 	0	0	xsd:unsignedInt
InternetGatewayDevice.LANDevice.1.LANEthernetInterfaceConfig.4.Stats.BroadcastPacketsSent 	0	0	xsd:unsignedInt
InternetGatewayDevice.LANDevice.1.LANEthernetInterfaceConfig.4.Stats.BytesReceived 	0	0	xsd:unsignedInt
InternetGatewayDevice.LANDevice.1.LANEthernetInterfaceConfig.4.Stats.BytesSent 	0	0	xsd:unsignedInt
InternetGatewayDevice.LANDevice.1.LANEthernetInterfaceConfig.4.Stats.DiscardPacketsReceived 	0	0	xsd:unsignedInt
InternetGatewayDevice.LANDevice.1.LANEthernetInterfaceConfig.4.Stats.DiscardPacketsSent 	0	0	xsd:unsignedInt
InternetGatewayDevice.LANDevice.1.LANEthernetInterfaceConfig.4.Stats.ErrorsReceived 	0	0	xsd:unsignedInt
InternetGatewayDevice.LANDevice.1.LANEthernetInterfaceConfig.4.Stats.ErrorsSent 	0	0	xsd:unsignedInt
InternetGatewayDevice.LANDevice.1.LANEthernetInterfaceConfig.4.Stats.MulticastPacketsReceived 	0	0	xsd:unsignedInt
InternetGatewayDevice.LANDevice.1.LANEthernetInterfaceConfig.4.Stats.MulticastPacketsSent 	0	0	xsd:unsignedInt
InternetGatewayDevice.LANDevice.1.LANEthernetInterfaceConfig.4.Stats.PacketsReceived 	0	0	xsd:unsignedInt
InternetGatewayDevice.LANDevice.1.LANEthernetInterfaceConfig.4.Stats.PacketsSent 	0	0	xsd:unsignedInt
InternetGatewayDevice.LANDevice.1.LANEthernetInterfaceConfig.4.Stats.UnicastPacketsReceived 	0	0	xsd:unsignedInt
InternetGatewayDevice.LANDevice.1.LANEthernetInterfaceConfig.4.Stats.UnicastPacketsSent 	0	0	xsd:unsignedInt
InternetGatewayDevice.LANDevice.1.LANEthernetInterfaceConfig.4.Stats.UnknownProtoPacketsReceived 	0	0	xsd:unsignedInt
InternetGatewayDevice.LANDevice.1.LANEthernetInterfaceConfig.4.Status 	 NoLink	0	xsd:string
InternetGatewayDevice.LANDevice.1.LANEthernetInterfaceNumberOfEntries 	1	0	xsd:unsignedInt
InternetGatewayDevice.LANDevice.1.LANHostConfigManagement.AllowedMACAddresses 	 undef	1	xsd:string
InternetGatewayDevice.LANDevice.1.LANHostConfigManagement.AssociatedConnection 	 undef	1	xsd:string
InternetGatewayDevice.LANDevice.1.LANHostConfigManagement.DHCPConditionalPoolNumberOfEntries 	0	0	xsd:unsignedInt
InternetGatewayDevice.LANDevice.1.LANHostConfigManagement.DHCPLeaseTime 	86400	1	xsd:int
InternetGatewayDevice.LANDevice.1.LANHostConfigManagement.DHCPOptionNumberOfEntries 	0	0	xsd:unsignedInt
InternetGatewayDevice.LANDevice.1.LANHostConfigManagement.DHCPRelay 	0	0	xsd:boolean
InternetGatewayDevice.LANDevice.1.LANHostConfigManagement.DHCPServerConfigurable 	1	1	xsd:boolean
InternetGatewayDevice.LANDevice.1.LANHostConfigManagement.DHCPServerEnable 	1	1	xsd:boolean
InternetGatewayDevice.LANDevice.1.LANHostConfigManagement.DNSServers 	 undef	1	xsd:string
InternetGatewayDevice.LANDevice.1.LANHostConfigManagement.DomainName 	 Home	1	xsd:string
InternetGatewayDevice.LANDevice.1.LANHostConfigManagement.IPInterface.1.Enable 	1	1	xsd:boolean
InternetGatewayDevice.LANDevice.1.LANHostConfigManagement.IPInterface.1.IPInterfaceAddressingType 	 Static	1	xsd:string
InternetGatewayDevice.LANDevice.1.LANHostConfigManagement.IPInterface.1.IPInterfaceIPAddress 	 192.168.1.1	1	xsd:string
InternetGatewayDevice.LANDevice.1.LANHostConfigManagement.IPInterface.1.IPInterfaceSubnetMask 	 255.255.255.0	1	xsd:string
InternetGatewayDevice.LANDevice.1.LANHostConfigManagement.IPInterfaceNumberOfEntries 	1	0	xsd:unsignedInt
InternetGatewayDevice.LANDevice.1.LANHostConfigManagement.IPRouters 	 192.168.1.1	1	xsd:string
InternetGatewayDevice.LANDevice.1.LANHostConfigManagement.MACAddress 	 8C:10:D4:30:FF:79	0	xsd:string
InternetGatewayDevice.LANDevice.1.LANHostConfigManagement.MaxAddress 	 192.168.1.254	1	xsd:string
InternetGatewayDevice.LANDevice.1.LANHostConfigManagement.MinAddress 	 192.168.1.2	1	xsd:string
InternetGatewayDevice.LANDevice.1.LANHostConfigManagement.PassthroughLease 	0	1	xsd:unsignedInt
InternetGatewayDevice.LANDevice.1.LANHostConfigManagement.PassthroughMACAddress 	 undef	1	xsd:string
InternetGatewayDevice.LANDevice.1.LANHostConfigManagement.ReservedAddresses 	 undef	1	xsd:string
InternetGatewayDevice.LANDevice.1.LANHostConfigManagement.SubnetMask 	 255.255.255.0	1	xsd:string
InternetGatewayDevice.LANDevice.1.LANHostConfigManagement.UseAllocatedWAN 	 Normal	1	xsd:string
InternetGatewayDevice.LANDevice.1.LANHostConfigManagement.X_EXT_DNSMode 	 Auto	1	xsd:string
InternetGatewayDevice.LANDevice.1.LANUSBInterfaceNumberOfEntries 	0	0	xsd:unsignedInt
InternetGatewayDevice.LANDevice.1.LANWLANConfigurationNumberOfEntries 	4	0	xsd:unsignedInt
InternetGatewayDevice.LANDevice.1.WLANConfiguration.1.APWMMParameter.1.AckPolicy 	1	1	xsd:boolean
InternetGatewayDevice.LANDevice.1.WLANConfiguration.1.APWMMParameter.1.AIFSN 	3	1	xsd:unsignedInt
InternetGatewayDevice.LANDevice.1.WLANConfiguration.1.APWMMParameter.1.ECWMax 	6	1	xsd:unsignedInt
InternetGatewayDevice.LANDevice.1.WLANConfiguration.1.APWMMParameter.1.ECWMin 	4	1	xsd:unsignedInt
InternetGatewayDevice.LANDevice.1.WLANConfiguration.1.APWMMParameter.1.TXOP 	0	1	xsd:unsignedInt
InternetGatewayDevice.LANDevice.1.WLANConfiguration.1.APWMMParameter.2.AckPolicy 	1	1	xsd:boolean
InternetGatewayDevice.LANDevice.1.WLANConfiguration.1.APWMMParameter.2.AIFSN 	7	1	xsd:unsignedInt
InternetGatewayDevice.LANDevice.1.WLANConfiguration.1.APWMMParameter.2.ECWMax 	10	1	xsd:unsignedInt
InternetGatewayDevice.LANDevice.1.WLANConfiguration.1.APWMMParameter.2.ECWMin 	4	1	xsd:unsignedInt
InternetGatewayDevice.LANDevice.1.WLANConfiguration.1.APWMMParameter.2.TXOP 	0	1	xsd:unsignedInt
InternetGatewayDevice.LANDevice.1.WLANConfiguration.1.APWMMParameter.3.AckPolicy 	1	1	xsd:unsignedInt
InternetGatewayDevice.LANDevice.1.WLANConfiguration.1.APWMMParameter.3.AIFSN 	1	1	xsd:unsignedInt
InternetGatewayDevice.LANDevice.1.WLANConfiguration.1.APWMMParameter.3.ECWMax 	4	1	xsd:unsignedInt
InternetGatewayDevice.LANDevice.1.WLANConfiguration.1.APWMMParameter.3.ECWMin 	3	1	xsd:unsignedInt
InternetGatewayDevice.LANDevice.1.WLANConfiguration.1.APWMMParameter.3.TXOP 	94	1	xsd:unsignedInt
InternetGatewayDevice.LANDevice.1.WLANConfiguration.1.APWMMParameter.4.AckPolicy 	1	1	xsd:boolean
InternetGatewayDevice.LANDevice.1.WLANConfiguration.1.APWMMParameter.4.AIFSN 	1	1	xsd:unsignedInt
InternetGatewayDevice.LANDevice.1.WLANConfiguration.1.APWMMParameter.4.ECWMax 	3	1	xsd:unsignedInt
InternetGatewayDevice.LANDevice.1.WLANConfiguration.1.APWMMParameter.4.ECWMin 	2	1	xsd:unsignedInt
InternetGatewayDevice.LANDevice.1.WLANConfiguration.1.APWMMParameter.4.TXOP 	47	1	xsd:unsignedInt
InternetGatewayDevice.LANDevice.1.WLANConfiguration.1.AuthenticationServiceMode 	 None	1	xsd:string
InternetGatewayDevice.LANDevice.1.WLANConfiguration.1.AutoChannelEnable 	1	1	xsd:boolean
InternetGatewayDevice.LANDevice.1.WLANConfiguration.1.AutoRateFallBackEnabled 	1	1	xsd:boolean
InternetGatewayDevice.LANDevice.1.WLANConfiguration.1.BasicAuthenticationMode 	 None	1	xsd:string
InternetGatewayDevice.LANDevice.1.WLANConfiguration.1.BasicDataTransmitRates 	 1,2,5.5,11	1	xsd:string
InternetGatewayDevice.LANDevice.1.WLANConfiguration.1.BasicEncryptionModes 	 None	1	xsd:string
InternetGatewayDevice.LANDevice.1.WLANConfiguration.1.BeaconAdvertisementEnabled 	1	1	xsd:boolean
InternetGatewayDevice.LANDevice.1.WLANConfiguration.1.BeaconType 	 WPAand11i	1	xsd:string
InternetGatewayDevice.LANDevice.1.WLANConfiguration.1.BSSID 	 8c:10:d4:30:ff:79	0	xsd:string
InternetGatewayDevice.LANDevice.1.WLANConfiguration.1.Channel 	9	1	xsd:unsignedInt
InternetGatewayDevice.LANDevice.1.WLANConfiguration.1.ChannelsInUse 	0	0	xsd:string
InternetGatewayDevice.LANDevice.1.WLANConfiguration.1.DeviceOperationMode 	 InfrastructureAccessPoint	1	xsd:string
InternetGatewayDevice.LANDevice.1.WLANConfiguration.1.Enable 	1	1	xsd:boolean
InternetGatewayDevice.LANDevice.1.WLANConfiguration.1.IEEE11iAuthenticationMode 	 PSKAuthentication	1	xsd:string
InternetGatewayDevice.LANDevice.1.WLANConfiguration.1.IEEE11iEncryptionModes 	 TKIPandAESEncryption	1	xsd:string
InternetGatewayDevice.LANDevice.1.WLANConfiguration.1.KeyPassphrase 	 undef	1	xsd:string
InternetGatewayDevice.LANDevice.1.WLANConfiguration.1.LocationDescription 	 undef	1	xsd:string
InternetGatewayDevice.LANDevice.1.WLANConfiguration.1.MACAddressControlEnabled 	0	1	xsd:boolean
InternetGatewayDevice.LANDevice.1.WLANConfiguration.1.MaxBitRate 	 Auto	1	xsd:string
InternetGatewayDevice.LANDevice.1.WLANConfiguration.1.Name 	 wlan0	0	xsd:string
InternetGatewayDevice.LANDevice.1.WLANConfiguration.1.OperationalDataTransmitRates 	 1,2,5.5,11,6,9,12,18,24,36,48,54	1	xsd:string
InternetGatewayDevice.LANDevice.1.WLANConfiguration.1.PossibleChannels 	 1-13	0	xsd:string
InternetGatewayDevice.LANDevice.1.WLANConfiguration.1.PossibleDataTransmitRates 	 1,2,5.5,11,6,9,12,18,24,36,48,54	0	xsd:string
InternetGatewayDevice.LANDevice.1.WLANConfiguration.1.PreSharedKey.1.AssociatedDeviceMACAddress 	 undef	1	xsd:string
InternetGatewayDevice.LANDevice.1.WLANConfiguration.1.PreSharedKey.1.KeyPassphrase 	 undef	1	xsd:string
InternetGatewayDevice.LANDevice.1.WLANConfiguration.1.PreSharedKey.1.PreSharedKey 	 undef	1	xsd:string
InternetGatewayDevice.LANDevice.1.WLANConfiguration.1.PreSharedKey.10.AssociatedDeviceMACAddress 	 undef	1	xsd:string
InternetGatewayDevice.LANDevice.1.WLANConfiguration.1.PreSharedKey.10.KeyPassphrase 	 undef	1	xsd:string
InternetGatewayDevice.LANDevice.1.WLANConfiguration.1.PreSharedKey.10.PreSharedKey 	 undef	1	xsd:string
InternetGatewayDevice.LANDevice.1.WLANConfiguration.1.PreSharedKey.2.AssociatedDeviceMACAddress 	 undef	1	xsd:string
InternetGatewayDevice.LANDevice.1.WLANConfiguration.1.PreSharedKey.2.KeyPassphrase 	 undef	1	xsd:string
InternetGatewayDevice.LANDevice.1.WLANConfiguration.1.PreSharedKey.2.PreSharedKey 	 undef	1	xsd:string
InternetGatewayDevice.LANDevice.1.WLANConfiguration.1.PreSharedKey.3.AssociatedDeviceMACAddress 	 undef	1	xsd:string
InternetGatewayDevice.LANDevice.1.WLANConfiguration.1.PreSharedKey.3.KeyPassphrase 	 undef	1	xsd:string
InternetGatewayDevice.LANDevice.1.WLANConfiguration.1.PreSharedKey.3.PreSharedKey 	 undef	1	xsd:string
InternetGatewayDevice.LANDevice.1.WLANConfiguration.1.PreSharedKey.4.AssociatedDeviceMACAddress 	 undef	1	xsd:string
InternetGatewayDevice.LANDevice.1.WLANConfiguration.1.PreSharedKey.4.KeyPassphrase 	 undef	1	xsd:string
InternetGatewayDevice.LANDevice.1.WLANConfiguration.1.PreSharedKey.4.PreSharedKey 	 undef	1	xsd:string
InternetGatewayDevice.LANDevice.1.WLANConfiguration.1.PreSharedKey.5.AssociatedDeviceMACAddress 	 undef	1	xsd:string
InternetGatewayDevice.LANDevice.1.WLANConfiguration.1.PreSharedKey.5.KeyPassphrase 	 undef	1	xsd:string
InternetGatewayDevice.LANDevice.1.WLANConfiguration.1.PreSharedKey.5.PreSharedKey 	 undef	1	xsd:string
InternetGatewayDevice.LANDevice.1.WLANConfiguration.1.PreSharedKey.6.AssociatedDeviceMACAddress 	 undef	1	xsd:string
InternetGatewayDevice.LANDevice.1.WLANConfiguration.1.PreSharedKey.6.KeyPassphrase 	 undef	1	xsd:string
InternetGatewayDevice.LANDevice.1.WLANConfiguration.1.PreSharedKey.6.PreSharedKey 	 undef	1	xsd:string
InternetGatewayDevice.LANDevice.1.WLANConfiguration.1.PreSharedKey.7.AssociatedDeviceMACAddress 	 undef	1	xsd:string
InternetGatewayDevice.LANDevice.1.WLANConfiguration.1.PreSharedKey.7.KeyPassphrase 	 undef	1	xsd:string
InternetGatewayDevice.LANDevice.1.WLANConfiguration.1.PreSharedKey.7.PreSharedKey 	 undef	1	xsd:string
InternetGatewayDevice.LANDevice.1.WLANConfiguration.1.PreSharedKey.8.AssociatedDeviceMACAddress 	 undef	1	xsd:string
InternetGatewayDevice.LANDevice.1.WLANConfiguration.1.PreSharedKey.8.KeyPassphrase 	 undef	1	xsd:string
InternetGatewayDevice.LANDevice.1.WLANConfiguration.1.PreSharedKey.8.PreSharedKey 	 undef	1	xsd:string
InternetGatewayDevice.LANDevice.1.WLANConfiguration.1.PreSharedKey.9.AssociatedDeviceMACAddress 	 undef	1	xsd:string
InternetGatewayDevice.LANDevice.1.WLANConfiguration.1.PreSharedKey.9.KeyPassphrase 	 undef	1	xsd:string
InternetGatewayDevice.LANDevice.1.WLANConfiguration.1.PreSharedKey.9.PreSharedKey 	 undef	1	xsd:string
InternetGatewayDevice.LANDevice.1.WLANConfiguration.1.RadioEnabled 	1	1	xsd:boolean
InternetGatewayDevice.LANDevice.1.WLANConfiguration.1.SSID 	 ROSTELECOM_FF79	1	xsd:string
InternetGatewayDevice.LANDevice.1.WLANConfiguration.1.SSIDAdvertisementEnabled 	1	1	xsd:boolean
InternetGatewayDevice.LANDevice.1.WLANConfiguration.1.Standard 	 b,g,n	0	xsd:string
InternetGatewayDevice.LANDevice.1.WLANConfiguration.1.Stats.BroadcastPacketsReceived 	0	0	xsd:unsignedInt
InternetGatewayDevice.LANDevice.1.WLANConfiguration.1.Stats.BroadcastPacketsSent 	0	0	xsd:unsignedInt
InternetGatewayDevice.LANDevice.1.WLANConfiguration.1.Stats.DiscardPacketsReceived 	0	0	xsd:unsignedInt
InternetGatewayDevice.LANDevice.1.WLANConfiguration.1.Stats.DiscardPacketsSent 	128	0	xsd:unsignedInt
InternetGatewayDevice.LANDevice.1.WLANConfiguration.1.Stats.ErrorsReceived 	0	0	xsd:unsignedInt
InternetGatewayDevice.LANDevice.1.WLANConfiguration.1.Stats.ErrorsSent 	0	0	xsd:unsignedInt
InternetGatewayDevice.LANDevice.1.WLANConfiguration.1.Stats.MulticastPacketsReceived 	0	0	xsd:unsignedInt
InternetGatewayDevice.LANDevice.1.WLANConfiguration.1.Stats.MulticastPacketsSent 	0	0	xsd:unsignedInt
InternetGatewayDevice.LANDevice.1.WLANConfiguration.1.Stats.UnicastPacketsReceived 	108151	0	xsd:unsignedInt
InternetGatewayDevice.LANDevice.1.WLANConfiguration.1.Stats.UnicastPacketsSent 	2493	0	xsd:unsignedInt
InternetGatewayDevice.LANDevice.1.WLANConfiguration.1.Stats.UnknownProtoPacketsReceived 	0	0	xsd:unsignedInt
InternetGatewayDevice.LANDevice.1.WLANConfiguration.1.Status 	 Up	0	xsd:string
InternetGatewayDevice.LANDevice.1.WLANConfiguration.1.STAWMMParameter.1.AckPolicy 	1	1	xsd:boolean
InternetGatewayDevice.LANDevice.1.WLANConfiguration.1.STAWMMParameter.1.AIFSN 	3	1	xsd:unsignedInt
InternetGatewayDevice.LANDevice.1.WLANConfiguration.1.STAWMMParameter.1.ECWMax 	6	1	xsd:unsignedInt
InternetGatewayDevice.LANDevice.1.WLANConfiguration.1.STAWMMParameter.1.ECWMin 	4	1	xsd:unsignedInt
InternetGatewayDevice.LANDevice.1.WLANConfiguration.1.STAWMMParameter.1.TXOP 	0	1	xsd:unsignedInt
InternetGatewayDevice.LANDevice.1.WLANConfiguration.1.STAWMMParameter.2.AckPolicy 	1	1	xsd:boolean
InternetGatewayDevice.LANDevice.1.WLANConfiguration.1.STAWMMParameter.2.AIFSN 	7	1	xsd:unsignedInt
InternetGatewayDevice.LANDevice.1.WLANConfiguration.1.STAWMMParameter.2.ECWMax 	10	1	xsd:unsignedInt
InternetGatewayDevice.LANDevice.1.WLANConfiguration.1.STAWMMParameter.2.ECWMin 	4	1	xsd:unsignedInt
InternetGatewayDevice.LANDevice.1.WLANConfiguration.1.STAWMMParameter.2.TXOP 	0	1	xsd:unsignedInt
InternetGatewayDevice.LANDevice.1.WLANConfiguration.1.STAWMMParameter.3.AckPolicy 	1	1	xsd:unsignedInt
InternetGatewayDevice.LANDevice.1.WLANConfiguration.1.STAWMMParameter.3.AIFSN 	1	1	xsd:unsignedInt
InternetGatewayDevice.LANDevice.1.WLANConfiguration.1.STAWMMParameter.3.ECWMax 	4	1	xsd:unsignedInt
InternetGatewayDevice.LANDevice.1.WLANConfiguration.1.STAWMMParameter.3.ECWMin 	3	1	xsd:unsignedInt
InternetGatewayDevice.LANDevice.1.WLANConfiguration.1.STAWMMParameter.3.TXOP 	94	1	xsd:unsignedInt
InternetGatewayDevice.LANDevice.1.WLANConfiguration.1.STAWMMParameter.4.AckPolicy 	1	1	xsd:boolean
InternetGatewayDevice.LANDevice.1.WLANConfiguration.1.STAWMMParameter.4.AIFSN 	1	1	xsd:unsignedInt
InternetGatewayDevice.LANDevice.1.WLANConfiguration.1.STAWMMParameter.4.ECWMax 	3	1	xsd:unsignedInt
InternetGatewayDevice.LANDevice.1.WLANConfiguration.1.STAWMMParameter.4.ECWMin 	2	1	xsd:unsignedInt
InternetGatewayDevice.LANDevice.1.WLANConfiguration.1.STAWMMParameter.4.TXOP 	47	1	xsd:unsignedInt
InternetGatewayDevice.LANDevice.1.WLANConfiguration.1.TotalAssociations 	0	0	xsd:unsignedInt
InternetGatewayDevice.LANDevice.1.WLANConfiguration.1.TotalBytesReceived 	26042438	0	xsd:unsignedInt
InternetGatewayDevice.LANDevice.1.WLANConfiguration.1.TotalBytesSent 	678943	0	xsd:unsignedInt
InternetGatewayDevice.LANDevice.1.WLANConfiguration.1.TotalPacketsReceived 	108151	0	xsd:unsignedInt
InternetGatewayDevice.LANDevice.1.WLANConfiguration.1.TotalPacketsSent 	2493	0	xsd:unsignedInt
InternetGatewayDevice.LANDevice.1.WLANConfiguration.1.TransmitPower 	100	1	xsd:unsignedInt
InternetGatewayDevice.LANDevice.1.WLANConfiguration.1.TransmitPowerSupported 	 10,25,50,80,100	0	xsd:string
InternetGatewayDevice.LANDevice.1.WLANConfiguration.1.UAPSDEnable 	0	1	xsd:boolean
InternetGatewayDevice.LANDevice.1.WLANConfiguration.1.UAPSDSupported 	0	0	xsd:boolean
InternetGatewayDevice.LANDevice.1.WLANConfiguration.1.WEPEncryptionLevel 	 Disabled,40-bit,104-bit	0	xsd:string
InternetGatewayDevice.LANDevice.1.WLANConfiguration.1.WEPKey.1.WEPKey 	 undef	1	xsd:string
InternetGatewayDevice.LANDevice.1.WLANConfiguration.1.WEPKey.2.WEPKey 	 undef	1	xsd:string
InternetGatewayDevice.LANDevice.1.WLANConfiguration.1.WEPKey.3.WEPKey 	 undef	1	xsd:string
InternetGatewayDevice.LANDevice.1.WLANConfiguration.1.WEPKey.4.WEPKey 	 undef	1	xsd:string
InternetGatewayDevice.LANDevice.1.WLANConfiguration.1.WEPKeyIndex 	1	1	xsd:unsignedInt
InternetGatewayDevice.LANDevice.1.WLANConfiguration.1.WMMEnable 	1	1	xsd:boolean
InternetGatewayDevice.LANDevice.1.WLANConfiguration.1.WMMSupported 	1	0	xsd:boolean
InternetGatewayDevice.LANDevice.1.WLANConfiguration.1.WPAAuthenticationMode 	 PSKAuthentication	1	xsd:string
InternetGatewayDevice.LANDevice.1.WLANConfiguration.1.WPAEncryptionModes 	 TKIPandAESEncryption	1	xsd:string
InternetGatewayDevice.LANDevice.1.WLANConfiguration.1.WPS.ConfigMethodsEnabled 	 Ethernet,Label,PushButton	1	xsd:string
InternetGatewayDevice.LANDevice.1.WLANConfiguration.1.WPS.ConfigMethodsSupported 	 PushButton	0	xsd:string
InternetGatewayDevice.LANDevice.1.WLANConfiguration.1.WPS.ConfigurationState 	 Configured	0	xsd:string
InternetGatewayDevice.LANDevice.1.WLANConfiguration.1.WPS.DeviceName 	 Internet Router Device	0	xsd:string
InternetGatewayDevice.LANDevice.1.WLANConfiguration.1.WPS.DevicePassword 	1411218	1	xsd:unsignedInt
InternetGatewayDevice.LANDevice.1.WLANConfiguration.1.WPS.Enable 	0	1	xsd:boolean
InternetGatewayDevice.LANDevice.1.WLANConfiguration.1.WPS.LastConfigurationError 	 NoError	0	xsd:string
InternetGatewayDevice.LANDevice.1.WLANConfiguration.1.WPS.Registrar.1.DeviceName 	 Internet Router Device	0	xsd:string
InternetGatewayDevice.LANDevice.1.WLANConfiguration.1.WPS.Registrar.1.Enable 	0	1	xsd:boolean
InternetGatewayDevice.LANDevice.1.WLANConfiguration.1.WPS.Registrar.1.UUID 	 63041253-1019-2006-1228-8c10d430ff79,	0	xsd:string
InternetGatewayDevice.LANDevice.1.WLANConfiguration.1.WPS.RegistrarEstablished 	0	0	xsd:boolean
InternetGatewayDevice.LANDevice.1.WLANConfiguration.1.WPS.RegistrarNumberOfEntries 	1	0	xsd:unsignedInt
InternetGatewayDevice.LANDevice.1.WLANConfiguration.1.WPS.SetupLock 	1	1	xsd:boolean
InternetGatewayDevice.LANDevice.1.WLANConfiguration.1.WPS.SetupLockedState 	 Unlocked	0	xsd:string
InternetGatewayDevice.LANDevice.1.WLANConfiguration.1.WPS.UUID 	 63041253-1019-2006-1228-8c10d430ff79,	0	xsd:string
InternetGatewayDevice.LANDevice.1.WLANConfiguration.1.WPS.Version 	16	0	xsd:unsignedInt
InternetGatewayDevice.LANDevice.1.WLANConfiguration.2.APWMMParameter.1.AckPolicy 	1	1	xsd:boolean
InternetGatewayDevice.LANDevice.1.WLANConfiguration.2.APWMMParameter.1.AIFSN 	3	1	xsd:unsignedInt
InternetGatewayDevice.LANDevice.1.WLANConfiguration.2.APWMMParameter.1.ECWMax 	6	1	xsd:unsignedInt
InternetGatewayDevice.LANDevice.1.WLANConfiguration.2.APWMMParameter.1.ECWMin 	4	1	xsd:unsignedInt
InternetGatewayDevice.LANDevice.1.WLANConfiguration.2.APWMMParameter.1.TXOP 	0	1	xsd:unsignedInt
InternetGatewayDevice.LANDevice.1.WLANConfiguration.2.APWMMParameter.2.AckPolicy 	1	1	xsd:boolean
InternetGatewayDevice.LANDevice.1.WLANConfiguration.2.APWMMParameter.2.AIFSN 	7	1	xsd:unsignedInt
InternetGatewayDevice.LANDevice.1.WLANConfiguration.2.APWMMParameter.2.ECWMax 	10	1	xsd:unsignedInt
InternetGatewayDevice.LANDevice.1.WLANConfiguration.2.APWMMParameter.2.ECWMin 	4	1	xsd:unsignedInt
InternetGatewayDevice.LANDevice.1.WLANConfiguration.2.APWMMParameter.2.TXOP 	0	1	xsd:unsignedInt
InternetGatewayDevice.LANDevice.1.WLANConfiguration.2.APWMMParameter.3.AckPolicy 	1	1	xsd:unsignedInt
InternetGatewayDevice.LANDevice.1.WLANConfiguration.2.APWMMParameter.3.AIFSN 	1	1	xsd:unsignedInt
InternetGatewayDevice.LANDevice.1.WLANConfiguration.2.APWMMParameter.3.ECWMax 	4	1	xsd:unsignedInt
InternetGatewayDevice.LANDevice.1.WLANConfiguration.2.APWMMParameter.3.ECWMin 	3	1	xsd:unsignedInt
InternetGatewayDevice.LANDevice.1.WLANConfiguration.2.APWMMParameter.3.TXOP 	94	1	xsd:unsignedInt
InternetGatewayDevice.LANDevice.1.WLANConfiguration.2.APWMMParameter.4.AckPolicy 	1	1	xsd:boolean
InternetGatewayDevice.LANDevice.1.WLANConfiguration.2.APWMMParameter.4.AIFSN 	1	1	xsd:unsignedInt
InternetGatewayDevice.LANDevice.1.WLANConfiguration.2.APWMMParameter.4.ECWMax 	3	1	xsd:unsignedInt
InternetGatewayDevice.LANDevice.1.WLANConfiguration.2.APWMMParameter.4.ECWMin 	2	1	xsd:unsignedInt
InternetGatewayDevice.LANDevice.1.WLANConfiguration.2.APWMMParameter.4.TXOP 	47	1	xsd:unsignedInt
InternetGatewayDevice.LANDevice.1.WLANConfiguration.2.AuthenticationServiceMode 	 None	1	xsd:string
InternetGatewayDevice.LANDevice.1.WLANConfiguration.2.AutoChannelEnable 	1	1	xsd:boolean
InternetGatewayDevice.LANDevice.1.WLANConfiguration.2.AutoRateFallBackEnabled 	1	1	xsd:boolean
InternetGatewayDevice.LANDevice.1.WLANConfiguration.2.BasicAuthenticationMode 	 None	1	xsd:string
InternetGatewayDevice.LANDevice.1.WLANConfiguration.2.BasicDataTransmitRates 	 1,2,5.5,11	1	xsd:string
InternetGatewayDevice.LANDevice.1.WLANConfiguration.2.BasicEncryptionModes 	 None	1	xsd:string
InternetGatewayDevice.LANDevice.1.WLANConfiguration.2.BeaconAdvertisementEnabled 	1	1	xsd:boolean
InternetGatewayDevice.LANDevice.1.WLANConfiguration.2.BeaconType 	 None	1	xsd:string
InternetGatewayDevice.LANDevice.1.WLANConfiguration.2.BSSID 	 8c:10:d4:30:ff:7a	0	xsd:string
InternetGatewayDevice.LANDevice.1.WLANConfiguration.2.Channel 	9	1	xsd:unsignedInt
InternetGatewayDevice.LANDevice.1.WLANConfiguration.2.ChannelsInUse 	0	0	xsd:string
InternetGatewayDevice.LANDevice.1.WLANConfiguration.2.DeviceOperationMode 	 InfrastructureAccessPoint	1	xsd:string
InternetGatewayDevice.LANDevice.1.WLANConfiguration.2.Enable 	0	1	xsd:boolean
InternetGatewayDevice.LANDevice.1.WLANConfiguration.2.IEEE11iAuthenticationMode 	 PSKAuthentication	1	xsd:string
InternetGatewayDevice.LANDevice.1.WLANConfiguration.2.IEEE11iEncryptionModes 	 AESEncryption	1	xsd:string
InternetGatewayDevice.LANDevice.1.WLANConfiguration.2.KeyPassphrase 	 undef	1	xsd:string
InternetGatewayDevice.LANDevice.1.WLANConfiguration.2.LocationDescription 	 undef	1	xsd:string
InternetGatewayDevice.LANDevice.1.WLANConfiguration.2.MACAddressControlEnabled 	0	1	xsd:boolean
InternetGatewayDevice.LANDevice.1.WLANConfiguration.2.MaxBitRate 	 Auto	1	xsd:string
InternetGatewayDevice.LANDevice.1.WLANConfiguration.2.Name 	 wlan1	0	xsd:string
InternetGatewayDevice.LANDevice.1.WLANConfiguration.2.OperationalDataTransmitRates 	 1,2,5.5,11,6,9,12,18,24,36,48,54	1	xsd:string
InternetGatewayDevice.LANDevice.1.WLANConfiguration.2.PossibleChannels 	 1-13	0	xsd:string
InternetGatewayDevice.LANDevice.1.WLANConfiguration.2.PossibleDataTransmitRates 	 1,2,5.5,11,6,9,12,18,24,36,48,54	0	xsd:string
InternetGatewayDevice.LANDevice.1.WLANConfiguration.2.PreSharedKey.1.AssociatedDeviceMACAddress 	 undef	1	xsd:string
InternetGatewayDevice.LANDevice.1.WLANConfiguration.2.PreSharedKey.1.KeyPassphrase 	 undef	1	xsd:string
InternetGatewayDevice.LANDevice.1.WLANConfiguration.2.PreSharedKey.1.PreSharedKey 	 undef	1	xsd:string
InternetGatewayDevice.LANDevice.1.WLANConfiguration.2.PreSharedKey.10.AssociatedDeviceMACAddress 	 undef	1	xsd:string
InternetGatewayDevice.LANDevice.1.WLANConfiguration.2.PreSharedKey.10.KeyPassphrase 	 undef	1	xsd:string
InternetGatewayDevice.LANDevice.1.WLANConfiguration.2.PreSharedKey.10.PreSharedKey 	 undef	1	xsd:string
InternetGatewayDevice.LANDevice.1.WLANConfiguration.2.PreSharedKey.2.AssociatedDeviceMACAddress 	 undef	1	xsd:string
InternetGatewayDevice.LANDevice.1.WLANConfiguration.2.PreSharedKey.2.KeyPassphrase 	 undef	1	xsd:string
InternetGatewayDevice.LANDevice.1.WLANConfiguration.2.PreSharedKey.2.PreSharedKey 	 undef	1	xsd:string
InternetGatewayDevice.LANDevice.1.WLANConfiguration.2.PreSharedKey.3.AssociatedDeviceMACAddress 	 undef	1	xsd:string
InternetGatewayDevice.LANDevice.1.WLANConfiguration.2.PreSharedKey.3.KeyPassphrase 	 undef	1	xsd:string
InternetGatewayDevice.LANDevice.1.WLANConfiguration.2.PreSharedKey.3.PreSharedKey 	 undef	1	xsd:string
InternetGatewayDevice.LANDevice.1.WLANConfiguration.2.PreSharedKey.4.AssociatedDeviceMACAddress 	 undef	1	xsd:string
InternetGatewayDevice.LANDevice.1.WLANConfiguration.2.PreSharedKey.4.KeyPassphrase 	 undef	1	xsd:string
InternetGatewayDevice.LANDevice.1.WLANConfiguration.2.PreSharedKey.4.PreSharedKey 	 undef	1	xsd:string
InternetGatewayDevice.LANDevice.1.WLANConfiguration.2.PreSharedKey.5.AssociatedDeviceMACAddress 	 undef	1	xsd:string
InternetGatewayDevice.LANDevice.1.WLANConfiguration.2.PreSharedKey.5.KeyPassphrase 	 undef	1	xsd:string
InternetGatewayDevice.LANDevice.1.WLANConfiguration.2.PreSharedKey.5.PreSharedKey 	 undef	1	xsd:string
InternetGatewayDevice.LANDevice.1.WLANConfiguration.2.PreSharedKey.6.AssociatedDeviceMACAddress 	 undef	1	xsd:string
InternetGatewayDevice.LANDevice.1.WLANConfiguration.2.PreSharedKey.6.KeyPassphrase 	 undef	1	xsd:string
InternetGatewayDevice.LANDevice.1.WLANConfiguration.2.PreSharedKey.6.PreSharedKey 	 undef	1	xsd:string
InternetGatewayDevice.LANDevice.1.WLANConfiguration.2.PreSharedKey.7.AssociatedDeviceMACAddress 	 undef	1	xsd:string
InternetGatewayDevice.LANDevice.1.WLANConfiguration.2.PreSharedKey.7.KeyPassphrase 	 undef	1	xsd:string
InternetGatewayDevice.LANDevice.1.WLANConfiguration.2.PreSharedKey.7.PreSharedKey 	 undef	1	xsd:string
InternetGatewayDevice.LANDevice.1.WLANConfiguration.2.PreSharedKey.8.AssociatedDeviceMACAddress 	 undef	1	xsd:string
InternetGatewayDevice.LANDevice.1.WLANConfiguration.2.PreSharedKey.8.KeyPassphrase 	 undef	1	xsd:string
InternetGatewayDevice.LANDevice.1.WLANConfiguration.2.PreSharedKey.8.PreSharedKey 	 undef	1	xsd:string
InternetGatewayDevice.LANDevice.1.WLANConfiguration.2.PreSharedKey.9.AssociatedDeviceMACAddress 	 undef	1	xsd:string
InternetGatewayDevice.LANDevice.1.WLANConfiguration.2.PreSharedKey.9.KeyPassphrase 	 undef	1	xsd:string
InternetGatewayDevice.LANDevice.1.WLANConfiguration.2.PreSharedKey.9.PreSharedKey 	 undef	1	xsd:string
InternetGatewayDevice.LANDevice.1.WLANConfiguration.2.RadioEnabled 	0	1	xsd:boolean
InternetGatewayDevice.LANDevice.1.WLANConfiguration.2.SSID 	 RTL867x-SSID_0	1	xsd:string
InternetGatewayDevice.LANDevice.1.WLANConfiguration.2.SSIDAdvertisementEnabled 	1	1	xsd:boolean
InternetGatewayDevice.LANDevice.1.WLANConfiguration.2.Standard 	 b,g,n	0	xsd:string
InternetGatewayDevice.LANDevice.1.WLANConfiguration.2.Stats.BroadcastPacketsReceived 	0	0	xsd:unsignedInt
InternetGatewayDevice.LANDevice.1.WLANConfiguration.2.Stats.BroadcastPacketsSent 	0	0	xsd:unsignedInt
InternetGatewayDevice.LANDevice.1.WLANConfiguration.2.Stats.DiscardPacketsReceived 	0	0	xsd:unsignedInt
InternetGatewayDevice.LANDevice.1.WLANConfiguration.2.Stats.DiscardPacketsSent 	0	0	xsd:unsignedInt
InternetGatewayDevice.LANDevice.1.WLANConfiguration.2.Stats.ErrorsReceived 	0	0	xsd:unsignedInt
InternetGatewayDevice.LANDevice.1.WLANConfiguration.2.Stats.ErrorsSent 	0	0	xsd:unsignedInt
InternetGatewayDevice.LANDevice.1.WLANConfiguration.2.Stats.MulticastPacketsReceived 	0	0	xsd:unsignedInt
InternetGatewayDevice.LANDevice.1.WLANConfiguration.2.Stats.MulticastPacketsSent 	0	0	xsd:unsignedInt
InternetGatewayDevice.LANDevice.1.WLANConfiguration.2.Stats.UnicastPacketsReceived 	0	0	xsd:unsignedInt
InternetGatewayDevice.LANDevice.1.WLANConfiguration.2.Stats.UnicastPacketsSent 	0	0	xsd:unsignedInt
InternetGatewayDevice.LANDevice.1.WLANConfiguration.2.Stats.UnknownProtoPacketsReceived 	0	0	xsd:unsignedInt
InternetGatewayDevice.LANDevice.1.WLANConfiguration.2.Status 	 Disabled	0	xsd:string
InternetGatewayDevice.LANDevice.1.WLANConfiguration.2.STAWMMParameter.1.AckPolicy 	1	1	xsd:boolean
InternetGatewayDevice.LANDevice.1.WLANConfiguration.2.STAWMMParameter.1.AIFSN 	3	1	xsd:unsignedInt
InternetGatewayDevice.LANDevice.1.WLANConfiguration.2.STAWMMParameter.1.ECWMax 	6	1	xsd:unsignedInt
InternetGatewayDevice.LANDevice.1.WLANConfiguration.2.STAWMMParameter.1.ECWMin 	4	1	xsd:unsignedInt
InternetGatewayDevice.LANDevice.1.WLANConfiguration.2.STAWMMParameter.1.TXOP 	0	1	xsd:unsignedInt
InternetGatewayDevice.LANDevice.1.WLANConfiguration.2.STAWMMParameter.2.AckPolicy 	1	1	xsd:boolean
InternetGatewayDevice.LANDevice.1.WLANConfiguration.2.STAWMMParameter.2.AIFSN 	7	1	xsd:unsignedInt
InternetGatewayDevice.LANDevice.1.WLANConfiguration.2.STAWMMParameter.2.ECWMax 	10	1	xsd:unsignedInt
InternetGatewayDevice.LANDevice.1.WLANConfiguration.2.STAWMMParameter.2.ECWMin 	4	1	xsd:unsignedInt
InternetGatewayDevice.LANDevice.1.WLANConfiguration.2.STAWMMParameter.2.TXOP 	0	1	xsd:unsignedInt
InternetGatewayDevice.LANDevice.1.WLANConfiguration.2.STAWMMParameter.3.AckPolicy 	1	1	xsd:unsignedInt
InternetGatewayDevice.LANDevice.1.WLANConfiguration.2.STAWMMParameter.3.AIFSN 	1	1	xsd:unsignedInt
InternetGatewayDevice.LANDevice.1.WLANConfiguration.2.STAWMMParameter.3.ECWMax 	4	1	xsd:unsignedInt
InternetGatewayDevice.LANDevice.1.WLANConfiguration.2.STAWMMParameter.3.ECWMin 	3	1	xsd:unsignedInt
InternetGatewayDevice.LANDevice.1.WLANConfiguration.2.STAWMMParameter.3.TXOP 	94	1	xsd:unsignedInt
InternetGatewayDevice.LANDevice.1.WLANConfiguration.2.STAWMMParameter.4.AckPolicy 	1	1	xsd:boolean
InternetGatewayDevice.LANDevice.1.WLANConfiguration.2.STAWMMParameter.4.AIFSN 	1	1	xsd:unsignedInt
InternetGatewayDevice.LANDevice.1.WLANConfiguration.2.STAWMMParameter.4.ECWMax 	3	1	xsd:unsignedInt
InternetGatewayDevice.LANDevice.1.WLANConfiguration.2.STAWMMParameter.4.ECWMin 	2	1	xsd:unsignedInt
InternetGatewayDevice.LANDevice.1.WLANConfiguration.2.STAWMMParameter.4.TXOP 	47	1	xsd:unsignedInt
InternetGatewayDevice.LANDevice.1.WLANConfiguration.2.TotalAssociations 	0	0	xsd:unsignedInt
InternetGatewayDevice.LANDevice.1.WLANConfiguration.2.TotalBytesReceived 	0	0	xsd:unsignedInt
InternetGatewayDevice.LANDevice.1.WLANConfiguration.2.TotalBytesSent 	0	0	xsd:unsignedInt
InternetGatewayDevice.LANDevice.1.WLANConfiguration.2.TotalPacketsReceived 	0	0	xsd:unsignedInt
InternetGatewayDevice.LANDevice.1.WLANConfiguration.2.TotalPacketsSent 	0	0	xsd:unsignedInt
InternetGatewayDevice.LANDevice.1.WLANConfiguration.2.TransmitPower 	100	1	xsd:unsignedInt
InternetGatewayDevice.LANDevice.1.WLANConfiguration.2.TransmitPowerSupported 	 10,25,50,80,100	0	xsd:string
InternetGatewayDevice.LANDevice.1.WLANConfiguration.2.UAPSDEnable 	0	1	xsd:boolean
InternetGatewayDevice.LANDevice.1.WLANConfiguration.2.UAPSDSupported 	0	0	xsd:boolean
InternetGatewayDevice.LANDevice.1.WLANConfiguration.2.WEPEncryptionLevel 	 Disabled,40-bit,104-bit	0	xsd:string
InternetGatewayDevice.LANDevice.1.WLANConfiguration.2.WEPKey.1.WEPKey 	 undef	1	xsd:string
InternetGatewayDevice.LANDevice.1.WLANConfiguration.2.WEPKey.2.WEPKey 	 undef	1	xsd:string
InternetGatewayDevice.LANDevice.1.WLANConfiguration.2.WEPKey.3.WEPKey 	 undef	1	xsd:string
InternetGatewayDevice.LANDevice.1.WLANConfiguration.2.WEPKey.4.WEPKey 	 undef	1	xsd:string
InternetGatewayDevice.LANDevice.1.WLANConfiguration.2.WEPKeyIndex 	1	1	xsd:unsignedInt
InternetGatewayDevice.LANDevice.1.WLANConfiguration.2.WMMEnable 	1	1	xsd:boolean
InternetGatewayDevice.LANDevice.1.WLANConfiguration.2.WMMSupported 	1	0	xsd:boolean
InternetGatewayDevice.LANDevice.1.WLANConfiguration.2.WPAAuthenticationMode 	 PSKAuthentication	1	xsd:string
InternetGatewayDevice.LANDevice.1.WLANConfiguration.2.WPAEncryptionModes 	 TKIPEncryption	1	xsd:string
InternetGatewayDevice.LANDevice.1.WLANConfiguration.3.APWMMParameter.1.AckPolicy 	1	1	xsd:unsignedInt
InternetGatewayDevice.LANDevice.1.WLANConfiguration.3.APWMMParameter.1.AIFSN 	3	1	xsd:unsignedInt
InternetGatewayDevice.LANDevice.1.WLANConfiguration.3.APWMMParameter.1.ECWMax 	6	1	xsd:unsignedInt
InternetGatewayDevice.LANDevice.1.WLANConfiguration.3.APWMMParameter.1.ECWMin 	4	1	xsd:unsignedInt
InternetGatewayDevice.LANDevice.1.WLANConfiguration.3.APWMMParameter.1.TXOP 	0	1	xsd:unsignedInt
InternetGatewayDevice.LANDevice.1.WLANConfiguration.3.APWMMParameter.2.AckPolicy 	1	1	xsd:unsignedInt
InternetGatewayDevice.LANDevice.1.WLANConfiguration.3.APWMMParameter.2.AIFSN 	7	1	xsd:unsignedInt
InternetGatewayDevice.LANDevice.1.WLANConfiguration.3.APWMMParameter.2.ECWMax 	10	1	xsd:unsignedInt
InternetGatewayDevice.LANDevice.1.WLANConfiguration.3.APWMMParameter.2.ECWMin 	4	1	xsd:unsignedInt
InternetGatewayDevice.LANDevice.1.WLANConfiguration.3.APWMMParameter.2.TXOP 	0	1	xsd:unsignedInt
InternetGatewayDevice.LANDevice.1.WLANConfiguration.3.APWMMParameter.3.AckPolicy 	1	1	xsd:unsignedInt
InternetGatewayDevice.LANDevice.1.WLANConfiguration.3.APWMMParameter.3.AIFSN 	1	1	xsd:unsignedInt
InternetGatewayDevice.LANDevice.1.WLANConfiguration.3.APWMMParameter.3.ECWMax 	4	1	xsd:unsignedInt
InternetGatewayDevice.LANDevice.1.WLANConfiguration.3.APWMMParameter.3.ECWMin 	3	1	xsd:unsignedInt
InternetGatewayDevice.LANDevice.1.WLANConfiguration.3.APWMMParameter.3.TXOP 	94	1	xsd:unsignedInt
InternetGatewayDevice.LANDevice.1.WLANConfiguration.3.APWMMParameter.4.AckPolicy 	1	1	xsd:unsignedInt
InternetGatewayDevice.LANDevice.1.WLANConfiguration.3.APWMMParameter.4.AIFSN 	1	1	xsd:unsignedInt
InternetGatewayDevice.LANDevice.1.WLANConfiguration.3.APWMMParameter.4.ECWMax 	3	1	xsd:unsignedInt
InternetGatewayDevice.LANDevice.1.WLANConfiguration.3.APWMMParameter.4.ECWMin 	2	1	xsd:unsignedInt
InternetGatewayDevice.LANDevice.1.WLANConfiguration.3.APWMMParameter.4.TXOP 	47	1	xsd:unsignedInt
InternetGatewayDevice.LANDevice.1.WLANConfiguration.3.AuthenticationServiceMode 	 None	1	xsd:unsignedInt
InternetGatewayDevice.LANDevice.1.WLANConfiguration.3.AutoChannelEnable 	1	1	xsd:unsignedInt
InternetGatewayDevice.LANDevice.1.WLANConfiguration.3.AutoRateFallBackEnabled 	1	1	xsd:unsignedInt
InternetGatewayDevice.LANDevice.1.WLANConfiguration.3.BasicAuthenticationMode 	 None	1	xsd:unsignedInt
InternetGatewayDevice.LANDevice.1.WLANConfiguration.3.BasicDataTransmitRates 	 1,2,5.5,11	1	xsd:unsignedInt
InternetGatewayDevice.LANDevice.1.WLANConfiguration.3.BasicEncryptionModes 	 None	1	xsd:unsignedInt
InternetGatewayDevice.LANDevice.1.WLANConfiguration.3.BeaconAdvertisementEnabled 	1	1	xsd:unsignedInt
InternetGatewayDevice.LANDevice.1.WLANConfiguration.3.BeaconType 	 None	1	xsd:unsignedInt
InternetGatewayDevice.LANDevice.1.WLANConfiguration.3.BSSID 	 8c:10:d4:30:ff:7b	0	xsd:unsignedInt
InternetGatewayDevice.LANDevice.1.WLANConfiguration.3.Channel 	9	1	xsd:unsignedInt
InternetGatewayDevice.LANDevice.1.WLANConfiguration.3.ChannelsInUse 	0	0	xsd:unsignedInt
InternetGatewayDevice.LANDevice.1.WLANConfiguration.3.DeviceOperationMode 	 InfrastructureAccessPoint	1	xsd:unsignedInt
InternetGatewayDevice.LANDevice.1.WLANConfiguration.3.Enable 	0	1	xsd:unsignedInt
InternetGatewayDevice.LANDevice.1.WLANConfiguration.3.IEEE11iAuthenticationMode 	 PSKAuthentication	1	xsd:unsignedInt
InternetGatewayDevice.LANDevice.1.WLANConfiguration.3.IEEE11iEncryptionModes 	 AESEncryption	1	xsd:unsignedInt
InternetGatewayDevice.LANDevice.1.WLANConfiguration.3.KeyPassphrase 	 undef	1	xsd:unsignedInt
InternetGatewayDevice.LANDevice.1.WLANConfiguration.3.LocationDescription 	 undef	1	xsd:unsignedInt
InternetGatewayDevice.LANDevice.1.WLANConfiguration.3.MACAddressControlEnabled 	0	1	xsd:unsignedInt
InternetGatewayDevice.LANDevice.1.WLANConfiguration.3.MaxBitRate 	 Auto	1	xsd:unsignedInt
InternetGatewayDevice.LANDevice.1.WLANConfiguration.3.Name 	 wlan2	0	xsd:unsignedInt
InternetGatewayDevice.LANDevice.1.WLANConfiguration.3.OperationalDataTransmitRates 	 1,2,5.5,11,6,9,12,18,24,36,48,54	1	xsd:unsignedInt
InternetGatewayDevice.LANDevice.1.WLANConfiguration.3.PossibleChannels 	 1-13	0	xsd:unsignedInt
InternetGatewayDevice.LANDevice.1.WLANConfiguration.3.PossibleDataTransmitRates 	 1,2,5.5,11,6,9,12,18,24,36,48,54	0	xsd:unsignedInt
InternetGatewayDevice.LANDevice.1.WLANConfiguration.3.PreSharedKey.1.AssociatedDeviceMACAddress 	 undef	1	xsd:unsignedInt
InternetGatewayDevice.LANDevice.1.WLANConfiguration.3.PreSharedKey.1.KeyPassphrase 	 undef	1	xsd:unsignedInt
InternetGatewayDevice.LANDevice.1.WLANConfiguration.3.PreSharedKey.1.PreSharedKey 	 undef	1	xsd:unsignedInt
InternetGatewayDevice.LANDevice.1.WLANConfiguration.3.PreSharedKey.10.AssociatedDeviceMACAddress 	 undef	1	xsd:unsignedInt
InternetGatewayDevice.LANDevice.1.WLANConfiguration.3.PreSharedKey.10.KeyPassphrase 	 undef	1	xsd:unsignedInt
InternetGatewayDevice.LANDevice.1.WLANConfiguration.3.PreSharedKey.10.PreSharedKey 	 undef	1	xsd:unsignedInt
InternetGatewayDevice.LANDevice.1.WLANConfiguration.3.PreSharedKey.2.AssociatedDeviceMACAddress 	 undef	1	xsd:unsignedInt
InternetGatewayDevice.LANDevice.1.WLANConfiguration.3.PreSharedKey.2.KeyPassphrase 	 undef	1	xsd:unsignedInt
InternetGatewayDevice.LANDevice.1.WLANConfiguration.3.PreSharedKey.2.PreSharedKey 	 undef	1	xsd:unsignedInt
InternetGatewayDevice.LANDevice.1.WLANConfiguration.3.PreSharedKey.3.AssociatedDeviceMACAddress 	 undef	1	xsd:unsignedInt
InternetGatewayDevice.LANDevice.1.WLANConfiguration.3.PreSharedKey.3.KeyPassphrase 	 undef	1	xsd:unsignedInt
InternetGatewayDevice.LANDevice.1.WLANConfiguration.3.PreSharedKey.3.PreSharedKey 	 undef	1	xsd:unsignedInt
InternetGatewayDevice.LANDevice.1.WLANConfiguration.3.PreSharedKey.4.AssociatedDeviceMACAddress 	 undef	1	xsd:unsignedInt
InternetGatewayDevice.LANDevice.1.WLANConfiguration.3.PreSharedKey.4.KeyPassphrase 	 undef	1	xsd:unsignedInt
InternetGatewayDevice.LANDevice.1.WLANConfiguration.3.PreSharedKey.4.PreSharedKey 	 undef	1	xsd:unsignedInt
InternetGatewayDevice.LANDevice.1.WLANConfiguration.3.PreSharedKey.5.AssociatedDeviceMACAddress 	 undef	1	xsd:unsignedInt
InternetGatewayDevice.LANDevice.1.WLANConfiguration.3.PreSharedKey.5.KeyPassphrase 	 undef	1	xsd:unsignedInt
InternetGatewayDevice.LANDevice.1.WLANConfiguration.3.PreSharedKey.5.PreSharedKey 	 undef	1	xsd:unsignedInt
InternetGatewayDevice.LANDevice.1.WLANConfiguration.3.PreSharedKey.6.AssociatedDeviceMACAddress 	 undef	1	xsd:unsignedInt
InternetGatewayDevice.LANDevice.1.WLANConfiguration.3.PreSharedKey.6.KeyPassphrase 	 undef	1	xsd:unsignedInt
InternetGatewayDevice.LANDevice.1.WLANConfiguration.3.PreSharedKey.6.PreSharedKey 	 undef	1	xsd:unsignedInt
InternetGatewayDevice.LANDevice.1.WLANConfiguration.3.PreSharedKey.7.AssociatedDeviceMACAddress 	 undef	1	xsd:unsignedInt
InternetGatewayDevice.LANDevice.1.WLANConfiguration.3.PreSharedKey.7.KeyPassphrase 	 undef	1	xsd:unsignedInt
InternetGatewayDevice.LANDevice.1.WLANConfiguration.3.PreSharedKey.7.PreSharedKey 	 undef	1	xsd:unsignedInt
InternetGatewayDevice.LANDevice.1.WLANConfiguration.3.PreSharedKey.8.AssociatedDeviceMACAddress 	 undef	1	xsd:unsignedInt
InternetGatewayDevice.LANDevice.1.WLANConfiguration.3.PreSharedKey.8.KeyPassphrase 	 undef	1	xsd:unsignedInt
InternetGatewayDevice.LANDevice.1.WLANConfiguration.3.PreSharedKey.8.PreSharedKey 	 undef	1	xsd:unsignedInt
InternetGatewayDevice.LANDevice.1.WLANConfiguration.3.PreSharedKey.9.AssociatedDeviceMACAddress 	 undef	1	xsd:unsignedInt
InternetGatewayDevice.LANDevice.1.WLANConfiguration.3.PreSharedKey.9.KeyPassphrase 	 undef	1	xsd:unsignedInt
InternetGatewayDevice.LANDevice.1.WLANConfiguration.3.PreSharedKey.9.PreSharedKey 	 undef	1	xsd:unsignedInt
InternetGatewayDevice.LANDevice.1.WLANConfiguration.3.RadioEnabled 	0	1	xsd:unsignedInt
InternetGatewayDevice.LANDevice.1.WLANConfiguration.3.SSID 	 RTL867x-SSID_1	1	xsd:unsignedInt
InternetGatewayDevice.LANDevice.1.WLANConfiguration.3.SSIDAdvertisementEnabled 	1	1	xsd:unsignedInt
InternetGatewayDevice.LANDevice.1.WLANConfiguration.3.Standard 	 b,g,n	0	xsd:unsignedInt
InternetGatewayDevice.LANDevice.1.WLANConfiguration.3.Stats.BroadcastPacketsReceived 	0	0	xsd:unsignedInt
InternetGatewayDevice.LANDevice.1.WLANConfiguration.3.Stats.BroadcastPacketsSent 	0	0	xsd:unsignedInt
InternetGatewayDevice.LANDevice.1.WLANConfiguration.3.Stats.DiscardPacketsReceived 	0	0	xsd:unsignedInt
InternetGatewayDevice.LANDevice.1.WLANConfiguration.3.Stats.DiscardPacketsSent 	0	0	xsd:unsignedInt
InternetGatewayDevice.LANDevice.1.WLANConfiguration.3.Stats.ErrorsReceived 	0	0	xsd:unsignedInt
InternetGatewayDevice.LANDevice.1.WLANConfiguration.3.Stats.ErrorsSent 	0	0	xsd:unsignedInt
InternetGatewayDevice.LANDevice.1.WLANConfiguration.3.Stats.MulticastPacketsReceived 	0	0	xsd:unsignedInt
InternetGatewayDevice.LANDevice.1.WLANConfiguration.3.Stats.MulticastPacketsSent 	0	0	xsd:unsignedInt
InternetGatewayDevice.LANDevice.1.WLANConfiguration.3.Stats.UnicastPacketsReceived 	0	0	xsd:unsignedInt
InternetGatewayDevice.LANDevice.1.WLANConfiguration.3.Stats.UnicastPacketsSent 	0	0	xsd:unsignedInt
InternetGatewayDevice.LANDevice.1.WLANConfiguration.3.Stats.UnknownProtoPacketsReceived 	0	0	xsd:unsignedInt
InternetGatewayDevice.LANDevice.1.WLANConfiguration.3.Status 	 Disabled	0	xsd:unsignedInt
InternetGatewayDevice.LANDevice.1.WLANConfiguration.3.STAWMMParameter.1.AckPolicy 	1	1	xsd:unsignedInt
InternetGatewayDevice.LANDevice.1.WLANConfiguration.3.STAWMMParameter.1.AIFSN 	3	1	xsd:unsignedInt
InternetGatewayDevice.LANDevice.1.WLANConfiguration.3.STAWMMParameter.1.ECWMax 	6	1	xsd:unsignedInt
InternetGatewayDevice.LANDevice.1.WLANConfiguration.3.STAWMMParameter.1.ECWMin 	4	1	xsd:unsignedInt
InternetGatewayDevice.LANDevice.1.WLANConfiguration.3.STAWMMParameter.1.TXOP 	0	1	xsd:unsignedInt
InternetGatewayDevice.LANDevice.1.WLANConfiguration.3.STAWMMParameter.2.AckPolicy 	1	1	xsd:unsignedInt
InternetGatewayDevice.LANDevice.1.WLANConfiguration.3.STAWMMParameter.2.AIFSN 	7	1	xsd:unsignedInt
InternetGatewayDevice.LANDevice.1.WLANConfiguration.3.STAWMMParameter.2.ECWMax 	10	1	xsd:unsignedInt
InternetGatewayDevice.LANDevice.1.WLANConfiguration.3.STAWMMParameter.2.ECWMin 	4	1	xsd:unsignedInt
InternetGatewayDevice.LANDevice.1.WLANConfiguration.3.STAWMMParameter.2.TXOP 	0	1	xsd:unsignedInt
InternetGatewayDevice.LANDevice.1.WLANConfiguration.3.STAWMMParameter.3.AckPolicy 	1	1	xsd:unsignedInt
InternetGatewayDevice.LANDevice.1.WLANConfiguration.3.STAWMMParameter.3.AIFSN 	1	1	xsd:unsignedInt
InternetGatewayDevice.LANDevice.1.WLANConfiguration.3.STAWMMParameter.3.ECWMax 	4	1	xsd:unsignedInt
InternetGatewayDevice.LANDevice.1.WLANConfiguration.3.STAWMMParameter.3.ECWMin 	3	1	xsd:unsignedInt
InternetGatewayDevice.LANDevice.1.WLANConfiguration.3.STAWMMParameter.3.TXOP 	94	1	xsd:unsignedInt
InternetGatewayDevice.LANDevice.1.WLANConfiguration.3.STAWMMParameter.4.AckPolicy 	1	1	xsd:unsignedInt
InternetGatewayDevice.LANDevice.1.WLANConfiguration.3.STAWMMParameter.4.AIFSN 	1	1	xsd:unsignedInt
InternetGatewayDevice.LANDevice.1.WLANConfiguration.3.STAWMMParameter.4.ECWMax 	3	1	xsd:unsignedInt
InternetGatewayDevice.LANDevice.1.WLANConfiguration.3.STAWMMParameter.4.ECWMin 	2	1	xsd:unsignedInt
InternetGatewayDevice.LANDevice.1.WLANConfiguration.3.STAWMMParameter.4.TXOP 	47	1	xsd:unsignedInt
InternetGatewayDevice.LANDevice.1.WLANConfiguration.3.TotalAssociations 	0	0	xsd:unsignedInt
InternetGatewayDevice.LANDevice.1.WLANConfiguration.3.TotalBytesReceived 	0	0	xsd:unsignedInt
InternetGatewayDevice.LANDevice.1.WLANConfiguration.3.TotalBytesSent 	0	0	xsd:unsignedInt
InternetGatewayDevice.LANDevice.1.WLANConfiguration.3.TotalPacketsReceived 	0	0	xsd:unsignedInt
InternetGatewayDevice.LANDevice.1.WLANConfiguration.3.TotalPacketsSent 	0	0	xsd:unsignedInt
InternetGatewayDevice.LANDevice.1.WLANConfiguration.3.TransmitPower 	100	1	xsd:unsignedInt
InternetGatewayDevice.LANDevice.1.WLANConfiguration.3.TransmitPowerSupported 	 10,25,50,80,100	0	xsd:unsignedInt
InternetGatewayDevice.LANDevice.1.WLANConfiguration.3.UAPSDEnable 	0	1	xsd:unsignedInt
InternetGatewayDevice.LANDevice.1.WLANConfiguration.3.UAPSDSupported 	0	0	xsd:unsignedInt
InternetGatewayDevice.LANDevice.1.WLANConfiguration.3.WEPEncryptionLevel 	 Disabled,40-bit,104-bit	0	xsd:unsignedInt
InternetGatewayDevice.LANDevice.1.WLANConfiguration.3.WEPKey.1.WEPKey 	 undef	1	xsd:unsignedInt
InternetGatewayDevice.LANDevice.1.WLANConfiguration.3.WEPKey.2.WEPKey 	 undef	1	xsd:unsignedInt
InternetGatewayDevice.LANDevice.1.WLANConfiguration.3.WEPKey.3.WEPKey 	 undef	1	xsd:unsignedInt
InternetGatewayDevice.LANDevice.1.WLANConfiguration.3.WEPKey.4.WEPKey 	 undef	1	xsd:unsignedInt
InternetGatewayDevice.LANDevice.1.WLANConfiguration.3.WEPKeyIndex 	1	1	xsd:unsignedInt
InternetGatewayDevice.LANDevice.1.WLANConfiguration.3.WMMEnable 	1	1	xsd:unsignedInt
InternetGatewayDevice.LANDevice.1.WLANConfiguration.3.WMMSupported 	1	0	xsd:unsignedInt
InternetGatewayDevice.LANDevice.1.WLANConfiguration.3.WPAAuthenticationMode 	 PSKAuthentication	1	xsd:unsignedInt
InternetGatewayDevice.LANDevice.1.WLANConfiguration.3.WPAEncryptionModes 	 TKIPEncryption	1	xsd:unsignedInt
InternetGatewayDevice.LANDevice.1.WLANConfiguration.4.APWMMParameter.1.AckPolicy 	1	1	xsd:boolean
InternetGatewayDevice.LANDevice.1.WLANConfiguration.4.APWMMParameter.1.AIFSN 	3	1	xsd:unsignedInt
InternetGatewayDevice.LANDevice.1.WLANConfiguration.4.APWMMParameter.1.ECWMax 	6	1	xsd:unsignedInt
InternetGatewayDevice.LANDevice.1.WLANConfiguration.4.APWMMParameter.1.ECWMin 	4	1	xsd:unsignedInt
InternetGatewayDevice.LANDevice.1.WLANConfiguration.4.APWMMParameter.1.TXOP 	0	1	xsd:unsignedInt
InternetGatewayDevice.LANDevice.1.WLANConfiguration.4.APWMMParameter.2.AckPolicy 	1	1	xsd:boolean
InternetGatewayDevice.LANDevice.1.WLANConfiguration.4.APWMMParameter.2.AIFSN 	7	1	xsd:unsignedInt
InternetGatewayDevice.LANDevice.1.WLANConfiguration.4.APWMMParameter.2.ECWMax 	10	1	xsd:unsignedInt
InternetGatewayDevice.LANDevice.1.WLANConfiguration.4.APWMMParameter.2.ECWMin 	4	1	xsd:unsignedInt
InternetGatewayDevice.LANDevice.1.WLANConfiguration.4.APWMMParameter.2.TXOP 	0	1	xsd:unsignedInt
InternetGatewayDevice.LANDevice.1.WLANConfiguration.4.APWMMParameter.3.AckPolicy 	1	1	xsd:unsignedInt
InternetGatewayDevice.LANDevice.1.WLANConfiguration.4.APWMMParameter.3.AIFSN 	1	1	xsd:unsignedInt
InternetGatewayDevice.LANDevice.1.WLANConfiguration.4.APWMMParameter.3.ECWMax 	4	1	xsd:unsignedInt
InternetGatewayDevice.LANDevice.1.WLANConfiguration.4.APWMMParameter.3.ECWMin 	3	1	xsd:unsignedInt
InternetGatewayDevice.LANDevice.1.WLANConfiguration.4.APWMMParameter.3.TXOP 	94	1	xsd:unsignedInt
InternetGatewayDevice.LANDevice.1.WLANConfiguration.4.APWMMParameter.4.AckPolicy 	1	1	xsd:boolean
InternetGatewayDevice.LANDevice.1.WLANConfiguration.4.APWMMParameter.4.AIFSN 	1	1	xsd:unsignedInt
InternetGatewayDevice.LANDevice.1.WLANConfiguration.4.APWMMParameter.4.ECWMax 	3	1	xsd:unsignedInt
InternetGatewayDevice.LANDevice.1.WLANConfiguration.4.APWMMParameter.4.ECWMin 	2	1	xsd:unsignedInt
InternetGatewayDevice.LANDevice.1.WLANConfiguration.4.APWMMParameter.4.TXOP 	47	1	xsd:unsignedInt
InternetGatewayDevice.LANDevice.1.WLANConfiguration.4.AuthenticationServiceMode 	 None	1	xsd:string
InternetGatewayDevice.LANDevice.1.WLANConfiguration.4.AutoChannelEnable 	1	1	xsd:boolean
InternetGatewayDevice.LANDevice.1.WLANConfiguration.4.AutoRateFallBackEnabled 	1	1	xsd:boolean
InternetGatewayDevice.LANDevice.1.WLANConfiguration.4.BasicAuthenticationMode 	 None	1	xsd:string
InternetGatewayDevice.LANDevice.1.WLANConfiguration.4.BasicDataTransmitRates 	 1,2,5.5,11	1	xsd:string
InternetGatewayDevice.LANDevice.1.WLANConfiguration.4.BasicEncryptionModes 	 None	1	xsd:string
InternetGatewayDevice.LANDevice.1.WLANConfiguration.4.BeaconAdvertisementEnabled 	1	1	xsd:boolean
InternetGatewayDevice.LANDevice.1.WLANConfiguration.4.BeaconType 	 None	1	xsd:string
InternetGatewayDevice.LANDevice.1.WLANConfiguration.4.BSSID 	 8c:10:d4:30:ff:7c	0	xsd:string
InternetGatewayDevice.LANDevice.1.WLANConfiguration.4.Channel 	9	1	xsd:unsignedInt
InternetGatewayDevice.LANDevice.1.WLANConfiguration.4.ChannelsInUse 	0	0	xsd:string
InternetGatewayDevice.LANDevice.1.WLANConfiguration.4.DeviceOperationMode 	 InfrastructureAccessPoint	1	xsd:string
InternetGatewayDevice.LANDevice.1.WLANConfiguration.4.Enable 	0	1	xsd:boolean
InternetGatewayDevice.LANDevice.1.WLANConfiguration.4.IEEE11iAuthenticationMode 	 PSKAuthentication	1	xsd:string
InternetGatewayDevice.LANDevice.1.WLANConfiguration.4.IEEE11iEncryptionModes 	 AESEncryption	1	xsd:string
InternetGatewayDevice.LANDevice.1.WLANConfiguration.4.KeyPassphrase 	 undef	1	xsd:string
InternetGatewayDevice.LANDevice.1.WLANConfiguration.4.LocationDescription 	 undef	1	xsd:string
InternetGatewayDevice.LANDevice.1.WLANConfiguration.4.MACAddressControlEnabled 	0	1	xsd:boolean
InternetGatewayDevice.LANDevice.1.WLANConfiguration.4.MaxBitRate 	 Auto	1	xsd:string
InternetGatewayDevice.LANDevice.1.WLANConfiguration.4.Name 	 wlan3	0	xsd:string
InternetGatewayDevice.LANDevice.1.WLANConfiguration.4.OperationalDataTransmitRates 	 1,2,5.5,11,6,9,12,18,24,36,48,54	1	xsd:string
InternetGatewayDevice.LANDevice.1.WLANConfiguration.4.PossibleChannels 	 1-13	0	xsd:string
InternetGatewayDevice.LANDevice.1.WLANConfiguration.4.PossibleDataTransmitRates 	 1,2,5.5,11,6,9,12,18,24,36,48,54	0	xsd:string
InternetGatewayDevice.LANDevice.1.WLANConfiguration.4.PreSharedKey.1.AssociatedDeviceMACAddress 	 undef	1	xsd:string
InternetGatewayDevice.LANDevice.1.WLANConfiguration.4.PreSharedKey.1.KeyPassphrase 	 undef	1	xsd:string
InternetGatewayDevice.LANDevice.1.WLANConfiguration.4.PreSharedKey.1.PreSharedKey 	 undef	1	xsd:string
InternetGatewayDevice.LANDevice.1.WLANConfiguration.4.PreSharedKey.10.AssociatedDeviceMACAddress 	 undef	1	xsd:string
InternetGatewayDevice.LANDevice.1.WLANConfiguration.4.PreSharedKey.10.KeyPassphrase 	 undef	1	xsd:string
InternetGatewayDevice.LANDevice.1.WLANConfiguration.4.PreSharedKey.10.PreSharedKey 	 undef	1	xsd:string
InternetGatewayDevice.LANDevice.1.WLANConfiguration.4.PreSharedKey.2.AssociatedDeviceMACAddress 	 undef	1	xsd:string
InternetGatewayDevice.LANDevice.1.WLANConfiguration.4.PreSharedKey.2.KeyPassphrase 	 undef	1	xsd:string
InternetGatewayDevice.LANDevice.1.WLANConfiguration.4.PreSharedKey.2.PreSharedKey 	 undef	1	xsd:string
InternetGatewayDevice.LANDevice.1.WLANConfiguration.4.PreSharedKey.3.AssociatedDeviceMACAddress 	 undef	1	xsd:string
InternetGatewayDevice.LANDevice.1.WLANConfiguration.4.PreSharedKey.3.KeyPassphrase 	 undef	1	xsd:string
InternetGatewayDevice.LANDevice.1.WLANConfiguration.4.PreSharedKey.3.PreSharedKey 	 undef	1	xsd:string
InternetGatewayDevice.LANDevice.1.WLANConfiguration.4.PreSharedKey.4.AssociatedDeviceMACAddress 	 undef	1	xsd:string
InternetGatewayDevice.LANDevice.1.WLANConfiguration.4.PreSharedKey.4.KeyPassphrase 	 undef	1	xsd:string
InternetGatewayDevice.LANDevice.1.WLANConfiguration.4.PreSharedKey.4.PreSharedKey 	 undef	1	xsd:string
InternetGatewayDevice.LANDevice.1.WLANConfiguration.4.PreSharedKey.5.AssociatedDeviceMACAddress 	 undef	1	xsd:string
InternetGatewayDevice.LANDevice.1.WLANConfiguration.4.PreSharedKey.5.KeyPassphrase 	 undef	1	xsd:string
InternetGatewayDevice.LANDevice.1.WLANConfiguration.4.PreSharedKey.5.PreSharedKey 	 undef	1	xsd:string
InternetGatewayDevice.LANDevice.1.WLANConfiguration.4.PreSharedKey.6.AssociatedDeviceMACAddress 	 undef	1	xsd:string
InternetGatewayDevice.LANDevice.1.WLANConfiguration.4.PreSharedKey.6.KeyPassphrase 	 undef	1	xsd:string
InternetGatewayDevice.LANDevice.1.WLANConfiguration.4.PreSharedKey.6.PreSharedKey 	 undef	1	xsd:string
InternetGatewayDevice.LANDevice.1.WLANConfiguration.4.PreSharedKey.7.AssociatedDeviceMACAddress 	 undef	1	xsd:string
InternetGatewayDevice.LANDevice.1.WLANConfiguration.4.PreSharedKey.7.KeyPassphrase 	 undef	1	xsd:string
InternetGatewayDevice.LANDevice.1.WLANConfiguration.4.PreSharedKey.7.PreSharedKey 	 undef	1	xsd:string
InternetGatewayDevice.LANDevice.1.WLANConfiguration.4.PreSharedKey.8.AssociatedDeviceMACAddress 	 undef	1	xsd:string
InternetGatewayDevice.LANDevice.1.WLANConfiguration.4.PreSharedKey.8.KeyPassphrase 	 undef	1	xsd:string
InternetGatewayDevice.LANDevice.1.WLANConfiguration.4.PreSharedKey.8.PreSharedKey 	 undef	1	xsd:string
InternetGatewayDevice.LANDevice.1.WLANConfiguration.4.PreSharedKey.9.AssociatedDeviceMACAddress 	 undef	1	xsd:string
InternetGatewayDevice.LANDevice.1.WLANConfiguration.4.PreSharedKey.9.KeyPassphrase 	 undef	1	xsd:string
InternetGatewayDevice.LANDevice.1.WLANConfiguration.4.PreSharedKey.9.PreSharedKey 	 undef	1	xsd:string
InternetGatewayDevice.LANDevice.1.WLANConfiguration.4.RadioEnabled 	0	1	xsd:boolean
InternetGatewayDevice.LANDevice.1.WLANConfiguration.4.SSID 	 RTL867x-SSID_2	1	xsd:string
InternetGatewayDevice.LANDevice.1.WLANConfiguration.4.SSIDAdvertisementEnabled 	1	1	xsd:boolean
InternetGatewayDevice.LANDevice.1.WLANConfiguration.4.Standard 	 b,g,n	0	xsd:string
InternetGatewayDevice.LANDevice.1.WLANConfiguration.4.Stats.BroadcastPacketsReceived 	0	0	xsd:unsignedInt
InternetGatewayDevice.LANDevice.1.WLANConfiguration.4.Stats.BroadcastPacketsSent 	0	0	xsd:unsignedInt
InternetGatewayDevice.LANDevice.1.WLANConfiguration.4.Stats.DiscardPacketsReceived 	0	0	xsd:unsignedInt
InternetGatewayDevice.LANDevice.1.WLANConfiguration.4.Stats.DiscardPacketsSent 	0	0	xsd:unsignedInt
InternetGatewayDevice.LANDevice.1.WLANConfiguration.4.Stats.ErrorsReceived 	0	0	xsd:unsignedInt
InternetGatewayDevice.LANDevice.1.WLANConfiguration.4.Stats.ErrorsSent 	0	0	xsd:unsignedInt
InternetGatewayDevice.LANDevice.1.WLANConfiguration.4.Stats.MulticastPacketsReceived 	0	0	xsd:unsignedInt
InternetGatewayDevice.LANDevice.1.WLANConfiguration.4.Stats.MulticastPacketsSent 	0	0	xsd:unsignedInt
InternetGatewayDevice.LANDevice.1.WLANConfiguration.4.Stats.UnicastPacketsReceived 	0	0	xsd:unsignedInt
InternetGatewayDevice.LANDevice.1.WLANConfiguration.4.Stats.UnicastPacketsSent 	0	0	xsd:unsignedInt
InternetGatewayDevice.LANDevice.1.WLANConfiguration.4.Stats.UnknownProtoPacketsReceived 	0	0	xsd:unsignedInt
InternetGatewayDevice.LANDevice.1.WLANConfiguration.4.Status 	 Disabled	0	xsd:string
InternetGatewayDevice.LANDevice.1.WLANConfiguration.4.STAWMMParameter.1.AckPolicy 	1	1	xsd:boolean
InternetGatewayDevice.LANDevice.1.WLANConfiguration.4.STAWMMParameter.1.AIFSN 	3	1	xsd:unsignedInt
InternetGatewayDevice.LANDevice.1.WLANConfiguration.4.STAWMMParameter.1.ECWMax 	6	1	xsd:unsignedInt
InternetGatewayDevice.LANDevice.1.WLANConfiguration.4.STAWMMParameter.1.ECWMin 	4	1	xsd:unsignedInt
InternetGatewayDevice.LANDevice.1.WLANConfiguration.4.STAWMMParameter.1.TXOP 	0	1	xsd:unsignedInt
InternetGatewayDevice.LANDevice.1.WLANConfiguration.4.STAWMMParameter.2.AckPolicy 	1	1	xsd:boolean
InternetGatewayDevice.LANDevice.1.WLANConfiguration.4.STAWMMParameter.2.AIFSN 	7	1	xsd:unsignedInt
InternetGatewayDevice.LANDevice.1.WLANConfiguration.4.STAWMMParameter.2.ECWMax 	10	1	xsd:unsignedInt
InternetGatewayDevice.LANDevice.1.WLANConfiguration.4.STAWMMParameter.2.ECWMin 	4	1	xsd:unsignedInt
InternetGatewayDevice.LANDevice.1.WLANConfiguration.4.STAWMMParameter.2.TXOP 	0	1	xsd:unsignedInt
InternetGatewayDevice.LANDevice.1.WLANConfiguration.4.STAWMMParameter.3.AckPolicy 	1	1	xsd:unsignedInt
InternetGatewayDevice.LANDevice.1.WLANConfiguration.4.STAWMMParameter.3.AIFSN 	1	1	xsd:unsignedInt
InternetGatewayDevice.LANDevice.1.WLANConfiguration.4.STAWMMParameter.3.ECWMax 	4	1	xsd:unsignedInt
InternetGatewayDevice.LANDevice.1.WLANConfiguration.4.STAWMMParameter.3.ECWMin 	3	1	xsd:unsignedInt
InternetGatewayDevice.LANDevice.1.WLANConfiguration.4.STAWMMParameter.3.TXOP 	94	1	xsd:unsignedInt
InternetGatewayDevice.LANDevice.1.WLANConfiguration.4.STAWMMParameter.4.AckPolicy 	1	1	xsd:boolean
InternetGatewayDevice.LANDevice.1.WLANConfiguration.4.STAWMMParameter.4.AIFSN 	1	1	xsd:unsignedInt
InternetGatewayDevice.LANDevice.1.WLANConfiguration.4.STAWMMParameter.4.ECWMax 	3	1	xsd:unsignedInt
InternetGatewayDevice.LANDevice.1.WLANConfiguration.4.STAWMMParameter.4.ECWMin 	2	1	xsd:unsignedInt
InternetGatewayDevice.LANDevice.1.WLANConfiguration.4.STAWMMParameter.4.TXOP 	47	1	xsd:unsignedInt
InternetGatewayDevice.LANDevice.1.WLANConfiguration.4.TotalAssociations 	0	0	xsd:unsignedInt
InternetGatewayDevice.LANDevice.1.WLANConfiguration.4.TotalBytesReceived 	0	0	xsd:unsignedInt
InternetGatewayDevice.LANDevice.1.WLANConfiguration.4.TotalBytesSent 	0	0	xsd:unsignedInt
InternetGatewayDevice.LANDevice.1.WLANConfiguration.4.TotalPacketsReceived 	0	0	xsd:unsignedInt
InternetGatewayDevice.LANDevice.1.WLANConfiguration.4.TotalPacketsSent 	0	0	xsd:unsignedInt
InternetGatewayDevice.LANDevice.1.WLANConfiguration.4.TransmitPower 	100	1	xsd:unsignedInt
InternetGatewayDevice.LANDevice.1.WLANConfiguration.4.TransmitPowerSupported 	 10,25,50,80,100	0	xsd:string
InternetGatewayDevice.LANDevice.1.WLANConfiguration.4.UAPSDEnable 	0	1	xsd:boolean
InternetGatewayDevice.LANDevice.1.WLANConfiguration.4.UAPSDSupported 	0	0	xsd:boolean
InternetGatewayDevice.LANDevice.1.WLANConfiguration.4.WEPEncryptionLevel 	 Disabled,40-bit,104-bit	0	xsd:string
InternetGatewayDevice.LANDevice.1.WLANConfiguration.4.WEPKey.1.WEPKey 	 undef	1	xsd:string
InternetGatewayDevice.LANDevice.1.WLANConfiguration.4.WEPKey.2.WEPKey 	 undef	1	xsd:string
InternetGatewayDevice.LANDevice.1.WLANConfiguration.4.WEPKey.3.WEPKey 	 undef	1	xsd:string
InternetGatewayDevice.LANDevice.1.WLANConfiguration.4.WEPKey.4.WEPKey 	 undef	1	xsd:string
InternetGatewayDevice.LANDevice.1.WLANConfiguration.4.WEPKeyIndex 	1	1	xsd:unsignedInt
InternetGatewayDevice.LANDevice.1.WLANConfiguration.4.WMMEnable 	1	1	xsd:boolean
InternetGatewayDevice.LANDevice.1.WLANConfiguration.4.WMMSupported 	1	0	xsd:boolean
InternetGatewayDevice.LANDevice.1.WLANConfiguration.4.WPAAuthenticationMode 	 PSKAuthentication	1	xsd:string
InternetGatewayDevice.LANDevice.1.WLANConfiguration.4.WPAEncryptionModes 	 TKIPEncryption	1	xsd:string
InternetGatewayDevice.LANDeviceNumberOfEntries 	1	0	xsd:unsignedInt
InternetGatewayDevice.LANInterfaces.LANEthernetInterfaceNumberOfEntries 	0	0	xsd:unsignedInt
InternetGatewayDevice.LANInterfaces.LANUSBInterfaceNumberOfEntries 	0	0	xsd:unsignedInt
InternetGatewayDevice.LANInterfaces.LANWLANConfigurationNumberOfEntries 	0	0	xsd:unsignedInt
InternetGatewayDevice.Layer2Bridging.AvailableInterface.1.AvailableInterfaceKey 	1	0	xsd:unsignedInt
InternetGatewayDevice.Layer2Bridging.AvailableInterface.1.InterfaceReference 	 undef	0	xsd:string
InternetGatewayDevice.Layer2Bridging.AvailableInterface.1.InterfaceType 	 WANInterface	0	xsd:string
InternetGatewayDevice.Layer2Bridging.AvailableInterface.2.AvailableInterfaceKey 	2	0	xsd:unsignedInt
InternetGatewayDevice.Layer2Bridging.AvailableInterface.2.InterfaceReference 	 InternetGatewayDevice.LANDevice.1.LANEthernetInterfaceConfig.2,	0	xsd:string
InternetGatewayDevice.Layer2Bridging.AvailableInterface.2.InterfaceType 	 LANInterface	0	xsd:string
InternetGatewayDevice.Layer2Bridging.AvailableInterface.3.AvailableInterfaceKey 	3	0	xsd:string
InternetGatewayDevice.Layer2Bridging.AvailableInterface.3.InterfaceReference 	 InternetGatewayDevice.LANDevice.1.LANEthernetInterfaceConfig.3,	0	xsd:string
InternetGatewayDevice.Layer2Bridging.AvailableInterface.3.InterfaceType 	 LANInterface	0	xsd:string
InternetGatewayDevice.Layer2Bridging.AvailableInterface.4.AvailableInterfaceKey 	4	0	xsd:unsignedInt
InternetGatewayDevice.Layer2Bridging.AvailableInterface.4.InterfaceReference 	 InternetGatewayDevice.LANDevice.1.LANEthernetInterfaceConfig.4,	0	xsd:string
InternetGatewayDevice.Layer2Bridging.AvailableInterface.4.InterfaceType 	 LANInterface	0	xsd:string
InternetGatewayDevice.Layer2Bridging.AvailableInterface.5.AvailableInterfaceKey 	5	0	xsd:unsignedInt
InternetGatewayDevice.Layer2Bridging.AvailableInterface.5.InterfaceReference 	 InternetGatewayDevice.LANDevice.1.WLANConfiguration.1,	0	xsd:string
InternetGatewayDevice.Layer2Bridging.AvailableInterface.5.InterfaceType 	 LANInterface	0	xsd:string
InternetGatewayDevice.Layer2Bridging.AvailableInterface.6.AvailableInterfaceKey 	6	0	xsd:unsignedInt
InternetGatewayDevice.Layer2Bridging.AvailableInterface.6.InterfaceReference 	 InternetGatewayDevice.LANDevice.1.WLANConfiguration.2,	0	xsd:string
InternetGatewayDevice.Layer2Bridging.AvailableInterface.6.InterfaceType 	 LANInterface	0	xsd:string
InternetGatewayDevice.Layer2Bridging.AvailableInterface.7.AvailableInterfaceKey 	7	0	xsd:unsignedInt
InternetGatewayDevice.Layer2Bridging.AvailableInterface.7.InterfaceReference 	 InternetGatewayDevice.LANDevice.1.WLANConfiguration.3,	0	xsd:string
InternetGatewayDevice.Layer2Bridging.AvailableInterface.7.InterfaceType 	 LANInterface	0	xsd:string
InternetGatewayDevice.Layer2Bridging.AvailableInterface.8.AvailableInterfaceKey 	8	0	xsd:unsignedInt
InternetGatewayDevice.Layer2Bridging.AvailableInterface.8.InterfaceReference 	 InternetGatewayDevice.LANDevice.1.WLANConfiguration.4,	0	xsd:string
InternetGatewayDevice.Layer2Bridging.AvailableInterface.8.InterfaceType 	 LANInterface	0	xsd:string
InternetGatewayDevice.Layer2Bridging.AvailableInterfaceNumberOfEntries 	8	0	xsd:unsignedInt
InternetGatewayDevice.Layer2Bridging.Bridge.1.BridgeEnable 	1	1	xsd:boolean
InternetGatewayDevice.Layer2Bridging.Bridge.1.BridgeKey 	1	0	xsd:unsignedInt
InternetGatewayDevice.Layer2Bridging.Bridge.1.BridgeName 	 Default	1	xsd:string
InternetGatewayDevice.Layer2Bridging.Bridge.1.BridgeStatus 	 Enabled	0	xsd:string
InternetGatewayDevice.Layer2Bridging.Bridge.2.BridgeEnable 	1	1	xsd:boolean
InternetGatewayDevice.Layer2Bridging.Bridge.2.BridgeKey 	2	0	xsd:unsignedInt
InternetGatewayDevice.Layer2Bridging.Bridge.2.BridgeName 	 Group1	1	xsd:string
InternetGatewayDevice.Layer2Bridging.Bridge.2.BridgeStatus 	 Enabled	0	xsd:string
InternetGatewayDevice.Layer2Bridging.Bridge.3.BridgeEnable 	1	1	xsd:string
InternetGatewayDevice.Layer2Bridging.Bridge.3.BridgeKey 	3	0	xsd:string
InternetGatewayDevice.Layer2Bridging.Bridge.3.BridgeName 	 Group2	1	xsd:string
InternetGatewayDevice.Layer2Bridging.Bridge.3.BridgeStatus 	 Enabled	0	xsd:string
InternetGatewayDevice.Layer2Bridging.BridgeNumberOfEntries 	3	0	xsd:unsignedInt
InternetGatewayDevice.Layer2Bridging.Filter.1.ExclusivityOrder 	0	1	xsd:unsignedInt
InternetGatewayDevice.Layer2Bridging.Filter.1.FilterBridgeReference 	1	1	xsd:int
InternetGatewayDevice.Layer2Bridging.Filter.1.FilterEnable 	1	1	xsd:boolean
InternetGatewayDevice.Layer2Bridging.Filter.1.FilterInterface 	1	1	xsd:string
InternetGatewayDevice.Layer2Bridging.Filter.1.FilterKey 	1	0	xsd:unsignedInt
InternetGatewayDevice.Layer2Bridging.Filter.1.FilterStatus 	 Enabled	0	xsd:string
InternetGatewayDevice.Layer2Bridging.Filter.2.ExclusivityOrder 	0	1	xsd:unsignedInt
InternetGatewayDevice.Layer2Bridging.Filter.2.FilterBridgeReference 	1	1	xsd:int
InternetGatewayDevice.Layer2Bridging.Filter.2.FilterEnable 	1	1	xsd:boolean
InternetGatewayDevice.Layer2Bridging.Filter.2.FilterInterface 	2	1	xsd:string
InternetGatewayDevice.Layer2Bridging.Filter.2.FilterKey 	2	0	xsd:unsignedInt
InternetGatewayDevice.Layer2Bridging.Filter.2.FilterStatus 	 Enabled	0	xsd:string
InternetGatewayDevice.Layer2Bridging.Filter.3.ExclusivityOrder 	0	1	xsd:string
InternetGatewayDevice.Layer2Bridging.Filter.3.FilterBridgeReference 	2	1	xsd:string
InternetGatewayDevice.Layer2Bridging.Filter.3.FilterEnable 	1	1	xsd:string
InternetGatewayDevice.Layer2Bridging.Filter.3.FilterInterface 	3	1	xsd:string
InternetGatewayDevice.Layer2Bridging.Filter.3.FilterKey 	3	0	xsd:string
InternetGatewayDevice.Layer2Bridging.Filter.3.FilterStatus 	 Enabled	0	xsd:string
InternetGatewayDevice.Layer2Bridging.Filter.4.ExclusivityOrder 	0	1	xsd:unsignedInt
InternetGatewayDevice.Layer2Bridging.Filter.4.FilterBridgeReference 	2	1	xsd:int
InternetGatewayDevice.Layer2Bridging.Filter.4.FilterEnable 	1	1	xsd:boolean
InternetGatewayDevice.Layer2Bridging.Filter.4.FilterInterface 	4	1	xsd:string
InternetGatewayDevice.Layer2Bridging.Filter.4.FilterKey 	4	0	xsd:unsignedInt
InternetGatewayDevice.Layer2Bridging.Filter.4.FilterStatus 	 Enabled	0	xsd:string
InternetGatewayDevice.Layer2Bridging.Filter.5.ExclusivityOrder 	0	1	xsd:unsignedInt
InternetGatewayDevice.Layer2Bridging.Filter.5.FilterBridgeReference 	1	1	xsd:int
InternetGatewayDevice.Layer2Bridging.Filter.5.FilterEnable 	1	1	xsd:boolean
InternetGatewayDevice.Layer2Bridging.Filter.5.FilterInterface 	5	1	xsd:string
InternetGatewayDevice.Layer2Bridging.Filter.5.FilterKey 	5	0	xsd:unsignedInt
InternetGatewayDevice.Layer2Bridging.Filter.5.FilterStatus 	 Enabled	0	xsd:string
InternetGatewayDevice.Layer2Bridging.Filter.6.ExclusivityOrder 	0	1	xsd:unsignedInt
InternetGatewayDevice.Layer2Bridging.Filter.6.FilterBridgeReference 	3	1	xsd:int
InternetGatewayDevice.Layer2Bridging.Filter.6.FilterEnable 	1	1	xsd:boolean
InternetGatewayDevice.Layer2Bridging.Filter.6.FilterInterface 	6	1	xsd:string
InternetGatewayDevice.Layer2Bridging.Filter.6.FilterKey 	6	0	xsd:unsignedInt
InternetGatewayDevice.Layer2Bridging.Filter.6.FilterStatus 	 Enabled	0	xsd:string
InternetGatewayDevice.Layer2Bridging.Filter.7.ExclusivityOrder 	0	1	xsd:unsignedInt
InternetGatewayDevice.Layer2Bridging.Filter.7.FilterBridgeReference 	3	1	xsd:int
InternetGatewayDevice.Layer2Bridging.Filter.7.FilterEnable 	1	1	xsd:boolean
InternetGatewayDevice.Layer2Bridging.Filter.7.FilterInterface 	7	1	xsd:string
InternetGatewayDevice.Layer2Bridging.Filter.7.FilterKey 	7	0	xsd:unsignedInt
InternetGatewayDevice.Layer2Bridging.Filter.7.FilterStatus 	 Enabled	0	xsd:string
InternetGatewayDevice.Layer2Bridging.Filter.8.ExclusivityOrder 	0	1	xsd:unsignedInt
InternetGatewayDevice.Layer2Bridging.Filter.8.FilterBridgeReference 	3	1	xsd:int
InternetGatewayDevice.Layer2Bridging.Filter.8.FilterEnable 	1	1	xsd:boolean
InternetGatewayDevice.Layer2Bridging.Filter.8.FilterInterface 	8	1	xsd:string
InternetGatewayDevice.Layer2Bridging.Filter.8.FilterKey 	8	0	xsd:unsignedInt
InternetGatewayDevice.Layer2Bridging.Filter.8.FilterStatus 	 Enabled	0	xsd:string
InternetGatewayDevice.Layer2Bridging.FilterNumberOfEntries 	8	0	xsd:unsignedInt
InternetGatewayDevice.Layer2Bridging.MaxBridgeEntries 	5	0	xsd:unsignedInt
InternetGatewayDevice.Layer2Bridging.MaxFilterEntries 	32	0	xsd:unsignedInt
InternetGatewayDevice.Layer3Forwarding.DefaultConnectionService 	 InternetGatewayDevice.WANDevice.2.WANConnectionDevice.1.WANIPConnection.2,	1	xsd:string
InternetGatewayDevice.Layer3Forwarding.Forwarding.1.DestIPAddress 	 192.168.11.4	1	xsd:string
InternetGatewayDevice.Layer3Forwarding.Forwarding.1.DestSubnetMask 	 255.255.255.255	1	xsd:string
InternetGatewayDevice.Layer3Forwarding.Forwarding.1.Enable 	1	1	xsd:boolean
InternetGatewayDevice.Layer3Forwarding.Forwarding.1.ForwardingMetric 	1	1	xsd:int
InternetGatewayDevice.Layer3Forwarding.Forwarding.1.GatewayIPAddress 	 0.0.0.0	1	xsd:string
InternetGatewayDevice.Layer3Forwarding.Forwarding.1.Interface 	 InternetGatewayDevice.WANDevice.2.WANConnectionDevice.1.WANIPConnection.2,	1	xsd:string
InternetGatewayDevice.Layer3Forwarding.Forwarding.1.SourceIPAddress 	 0.0.0.0	1	xsd:string
InternetGatewayDevice.Layer3Forwarding.Forwarding.1.SourceSubnetMask 	 0.0.0.0	1	xsd:string
InternetGatewayDevice.Layer3Forwarding.Forwarding.1.StaticRoute 	0	0	xsd:boolean
InternetGatewayDevice.Layer3Forwarding.Forwarding.1.Status 	 Enabled	0	xsd:string
InternetGatewayDevice.Layer3Forwarding.Forwarding.1.Type 	 Host	1	xsd:string
InternetGatewayDevice.Layer3Forwarding.Forwarding.2.DestIPAddress 	 192.168.1.1	1	xsd:string
InternetGatewayDevice.Layer3Forwarding.Forwarding.2.DestSubnetMask 	 255.255.255.255	1	xsd:string
InternetGatewayDevice.Layer3Forwarding.Forwarding.2.Enable 	1	1	xsd:boolean
InternetGatewayDevice.Layer3Forwarding.Forwarding.2.ForwardingMetric 	1	1	xsd:int
InternetGatewayDevice.Layer3Forwarding.Forwarding.2.GatewayIPAddress 	 0.0.0.0	1	xsd:string
InternetGatewayDevice.Layer3Forwarding.Forwarding.2.Interface 	 InternetGatewayDevice.LANDevice.1.LANEthernetInterfaceConfig.1,	1	xsd:string
InternetGatewayDevice.Layer3Forwarding.Forwarding.2.SourceIPAddress 	 0.0.0.0	1	xsd:string
InternetGatewayDevice.Layer3Forwarding.Forwarding.2.SourceSubnetMask 	 0.0.0.0	1	xsd:string
InternetGatewayDevice.Layer3Forwarding.Forwarding.2.StaticRoute 	0	0	xsd:boolean
InternetGatewayDevice.Layer3Forwarding.Forwarding.2.Status 	 Enabled	0	xsd:string
InternetGatewayDevice.Layer3Forwarding.Forwarding.2.Type 	 Host	1	xsd:string
InternetGatewayDevice.Layer3Forwarding.ForwardNumberOfEntries 	2	0	xsd:unsignedInt
InternetGatewayDevice.ManagementServer.ConnectionRequestPassword 	 undef	1	xsd:string
InternetGatewayDevice.ManagementServer.ConnectionRequestURL 	 http://192.168.11.4:7547/tr069	0	
InternetGatewayDevice.ManagementServer.ConnectionRequestUsername 	 undef	1	xsd:string
InternetGatewayDevice.ManagementServer.DownloadProgressURL 	 undef	0	xsd:string
InternetGatewayDevice.ManagementServer.EnableCWMP 	1	1	xsd:boolean
InternetGatewayDevice.ManagementServer.KickURL 	 undef	0	xsd:string
InternetGatewayDevice.ManagementServer.ManageableDeviceNotificationLimit 	0	1	xsd:unsignedInt
InternetGatewayDevice.ManagementServer.ManageableDeviceNumberOfEntries 	0	0	xsd:unsignedInt
InternetGatewayDevice.ManagementServer.ParameterKey 	 undef	0	xsd:string
InternetGatewayDevice.ManagementServer.Password 	 undef	1	xsd:string
InternetGatewayDevice.ManagementServer.PeriodicInformEnable 	1	1	xsd:boolean
InternetGatewayDevice.ManagementServer.PeriodicInformInterval 	10	1	xsd:unsignedInt
InternetGatewayDevice.ManagementServer.PeriodicInformTime 	 0001-01-01T00:00:00Z	1	xsd:dateTime
InternetGatewayDevice.ManagementServer.UpgradesManaged 	0	1	xsd:boolean
InternetGatewayDevice.ManagementServer.URL 	 http://192.168.11.3	1	xsd:string
InternetGatewayDevice.ManagementServer.Username 	 undef	1	xsd:string
InternetGatewayDevice.QueueManagement.AppNumberOfEntries 	0	0	xsd:unsignedInt
InternetGatewayDevice.QueueManagement.AvailableAppList 	 undef	0	xsd:string
InternetGatewayDevice.QueueManagement.ClassificationNumberOfEntries 	0	0	xsd:unsignedInt
InternetGatewayDevice.QueueManagement.DefaultEthernetPriorityMark 	-1	1	xsd:int
InternetGatewayDevice.QueueManagement.Enable 	0	1	xsd:boolean
InternetGatewayDevice.QueueManagement.FlowNumberOfEntries 	0	0	xsd:unsignedInt
InternetGatewayDevice.QueueManagement.MaxAppEntries 	0	0	xsd:unsignedInt
InternetGatewayDevice.QueueManagement.MaxClassificationEntries 	13	0	xsd:unsignedInt
InternetGatewayDevice.QueueManagement.MaxFlowEntries 	0	0	xsd:unsignedInt
InternetGatewayDevice.QueueManagement.MaxPolicerEntries 	0	0	xsd:unsignedInt
InternetGatewayDevice.QueueManagement.MaxQueueEntries 	4	0	xsd:unsignedInt
InternetGatewayDevice.QueueManagement.MaxQueues 	4	0	xsd:unsignedInt
InternetGatewayDevice.QueueManagement.PolicerNumberOfEntries 	0	0	xsd:unsignedInt
InternetGatewayDevice.QueueManagement.Queue.1.DropAlgorithm 	 DT	1	xsd:string
InternetGatewayDevice.QueueManagement.Queue.1.QueueBufferLength 	0	0	xsd:unsignedInt
InternetGatewayDevice.QueueManagement.Queue.1.QueueEnable 	1	1	xsd:boolean
InternetGatewayDevice.QueueManagement.Queue.1.QueueInterface 	 undef	1	xsd:string
InternetGatewayDevice.QueueManagement.Queue.1.QueueKey 	1	0	xsd:unsignedInt
InternetGatewayDevice.QueueManagement.Queue.1.QueuePrecedence 	1	1	xsd:unsignedInt
InternetGatewayDevice.QueueManagement.Queue.1.QueueStatus 	 Enabled	0	xsd:string
InternetGatewayDevice.QueueManagement.Queue.2.DropAlgorithm 	 DT	1	xsd:string
InternetGatewayDevice.QueueManagement.Queue.2.QueueBufferLength 	0	0	xsd:unsignedInt
InternetGatewayDevice.QueueManagement.Queue.2.QueueEnable 	1	1	xsd:boolean
InternetGatewayDevice.QueueManagement.Queue.2.QueueInterface 	 undef	1	xsd:string
InternetGatewayDevice.QueueManagement.Queue.2.QueueKey 	2	0	xsd:unsignedInt
InternetGatewayDevice.QueueManagement.Queue.2.QueuePrecedence 	2	1	xsd:unsignedInt
InternetGatewayDevice.QueueManagement.Queue.2.QueueStatus 	 Enabled	0	xsd:string
InternetGatewayDevice.QueueManagement.Queue.3.DropAlgorithm 	 DT	1	xsd:string
InternetGatewayDevice.QueueManagement.Queue.3.QueueBufferLength 	0	0	xsd:string
InternetGatewayDevice.QueueManagement.Queue.3.QueueEnable 	1	1	xsd:string
InternetGatewayDevice.QueueManagement.Queue.3.QueueInterface 	 undef	1	xsd:string
InternetGatewayDevice.QueueManagement.Queue.3.QueueKey 	3	0	xsd:string
InternetGatewayDevice.QueueManagement.Queue.3.QueuePrecedence 	3	1	xsd:string
InternetGatewayDevice.QueueManagement.Queue.3.QueueStatus 	 Enabled	0	xsd:string
InternetGatewayDevice.QueueManagement.Queue.4.DropAlgorithm 	 DT	1	xsd:string
InternetGatewayDevice.QueueManagement.Queue.4.QueueBufferLength 	0	0	xsd:unsignedInt
InternetGatewayDevice.QueueManagement.Queue.4.QueueEnable 	1	1	xsd:boolean
InternetGatewayDevice.QueueManagement.Queue.4.QueueInterface 	 undef	1	xsd:string
InternetGatewayDevice.QueueManagement.Queue.4.QueueKey 	4	0	xsd:unsignedInt
InternetGatewayDevice.QueueManagement.Queue.4.QueuePrecedence 	4	1	xsd:unsignedInt
InternetGatewayDevice.QueueManagement.Queue.4.QueueStatus 	 Enabled	0	xsd:string
InternetGatewayDevice.QueueManagement.QueueNumberOfEntries 	4	0	xsd:unsignedInt
InternetGatewayDevice.Time.CurrentLocalTime 	 2012-01-01T11:19:45Z	0	xsd:dateTime
InternetGatewayDevice.Time.Enable 	1	1	xsd:boolean
InternetGatewayDevice.Time.LocalTimeZoneName 	 CST(ACSST)-10	1	xsd:string
InternetGatewayDevice.Time.NTPServer1 	 ntp.local	1	xsd:string
InternetGatewayDevice.Time.NTPServer2 	 time.nist.gov	1	xsd:string
InternetGatewayDevice.Time.NTPServer3 	 undef	1	xsd:string
InternetGatewayDevice.Time.NTPServer4 	 undef	1	xsd:string
InternetGatewayDevice.Time.NTPServer5 	 undef	1	xsd:string
InternetGatewayDevice.Time.Status 	 Error_FailedToSynchronize	0	xsd:string
InternetGatewayDevice.TraceRouteDiagnostics.DataBlockSize 	38	1	xsd:unsignedInt
InternetGatewayDevice.TraceRouteDiagnostics.DiagnosticsState 	 None	1	xsd:string
InternetGatewayDevice.TraceRouteDiagnostics.DSCP 	0	1	xsd:unsignedInt
InternetGatewayDevice.TraceRouteDiagnostics.Host 	 undef	1	xsd:string
InternetGatewayDevice.TraceRouteDiagnostics.Interface 	 undef	1	xsd:string
InternetGatewayDevice.TraceRouteDiagnostics.MaxHopCount 	30	1	xsd:unsignedInt
InternetGatewayDevice.TraceRouteDiagnostics.NumberOfTries 	3	1	xsd:unsignedInt
InternetGatewayDevice.TraceRouteDiagnostics.ResponseTime 	0	0	xsd:unsignedInt
InternetGatewayDevice.TraceRouteDiagnostics.RouteHopsNumberOfEntries 	0	0	xsd:unsignedInt
InternetGatewayDevice.TraceRouteDiagnostics.Timeout 	5000	1	xsd:unsignedInt
InternetGatewayDevice.UDPEchoConfig.BytesReceived 	0	0	xsd:unsignedInt
InternetGatewayDevice.UDPEchoConfig.BytesResponded 	0	0	xsd:unsignedInt
InternetGatewayDevice.UDPEchoConfig.EchoPlusEnabled 	0	1	xsd:boolean
InternetGatewayDevice.UDPEchoConfig.EchoPlusSupported 	1	0	xsd:boolean
InternetGatewayDevice.UDPEchoConfig.Enable 	0	1	xsd:boolean
InternetGatewayDevice.UDPEchoConfig.Interface 	 undef	1	xsd:string
InternetGatewayDevice.UDPEchoConfig.PacketsReceived 	0	0	xsd:unsignedInt
InternetGatewayDevice.UDPEchoConfig.PacketsResponded 	0	0	xsd:unsignedInt
InternetGatewayDevice.UDPEchoConfig.SourceIPAddress 	 0.0.0.0	1	xsd:string
InternetGatewayDevice.UDPEchoConfig.TimeFirstPacketReceived 	 0001-01-01T00:00:00.000000	0	xsd:dateTime
InternetGatewayDevice.UDPEchoConfig.TimeLastPacketReceived 	 0001-01-01T00:00:00.000000	0	xsd:dateTime
InternetGatewayDevice.UDPEchoConfig.UDPPort 	0	1	xsd:unsignedInt
InternetGatewayDevice.UploadDiagnostics.BOMTime 	 0001-01-01T00:00:00.000000	0	xsd:dateTime
InternetGatewayDevice.UploadDiagnostics.DiagnosticsState 	 None	1	xsd:string
InternetGatewayDevice.UploadDiagnostics.DSCP 	0	1	xsd:unsignedInt
InternetGatewayDevice.UploadDiagnostics.EOMTime 	 0001-01-01T00:00:00.000000	0	xsd:dateTime
InternetGatewayDevice.UploadDiagnostics.EthernetPriority 	0	1	xsd:unsignedInt
InternetGatewayDevice.UploadDiagnostics.Interface 	 undef	1	xsd:string
InternetGatewayDevice.UploadDiagnostics.ROMTime 	 0001-01-01T00:00:00.000000	0	xsd:dateTime
InternetGatewayDevice.UploadDiagnostics.TCPOpenRequestTime 	 0001-01-01T00:00:00.000000	0	xsd:dateTime
InternetGatewayDevice.UploadDiagnostics.TCPOpenResponseTime 	 0001-01-01T00:00:00.000000	0	xsd:dateTime
InternetGatewayDevice.UploadDiagnostics.TestFileLength 	0	1	xsd:unsignedInt
InternetGatewayDevice.UploadDiagnostics.TotalBytesSent 	0	0	xsd:unsignedInt
InternetGatewayDevice.UploadDiagnostics.UploadURL 	 undef	1	xsd:string
InternetGatewayDevice.WANDevice.1.WANCommonInterfaceConfig.EnabledForInternet 	0	1	xsd:boolean
InternetGatewayDevice.WANDevice.1.WANCommonInterfaceConfig.Layer1DownstreamMaxBitRate 	0	0	xsd:unsignedInt
InternetGatewayDevice.WANDevice.1.WANCommonInterfaceConfig.Layer1UpstreamMaxBitRate 	0	0	xsd:unsignedInt
InternetGatewayDevice.WANDevice.1.WANCommonInterfaceConfig.MaximumActiveConnections 	8	0	xsd:unsignedInt
InternetGatewayDevice.WANDevice.1.WANCommonInterfaceConfig.NumberOfActiveConnections 	0	0	xsd:unsignedInt
InternetGatewayDevice.WANDevice.1.WANCommonInterfaceConfig.PhysicalLinkStatus 	 Down	0	xsd:string
InternetGatewayDevice.WANDevice.1.WANCommonInterfaceConfig.TotalBytesReceived 	0	0	xsd:unsignedInt
InternetGatewayDevice.WANDevice.1.WANCommonInterfaceConfig.TotalBytesSent 	0	0	xsd:unsignedInt
InternetGatewayDevice.WANDevice.1.WANCommonInterfaceConfig.TotalPacketsReceived 	0	0	xsd:unsignedInt
InternetGatewayDevice.WANDevice.1.WANCommonInterfaceConfig.TotalPacketsSent 	0	0	xsd:unsignedInt
InternetGatewayDevice.WANDevice.1.WANCommonInterfaceConfig.WANAccessProvider 	 undef	0	xsd:string
InternetGatewayDevice.WANDevice.1.WANCommonInterfaceConfig.WANAccessType 	 DSL	0	xsd:string
InternetGatewayDevice.WANDevice.1.WANConnectionNumberOfEntries 	0	0	xsd:unsignedInt
InternetGatewayDevice.WANDevice.1.WANDSLConnectionManagement.ConnectionService.1.ConnectionType 	 IP_Routed	0	xsd:string
InternetGatewayDevice.WANDevice.1.WANDSLConnectionManagement.ConnectionService.1.DestinationAddress 	 PVC:0/65535	0	xsd:string
InternetGatewayDevice.WANDevice.1.WANDSLConnectionManagement.ConnectionService.1.LinkType 	 EoA	0	xsd:string
InternetGatewayDevice.WANDevice.1.WANDSLConnectionManagement.ConnectionService.1.WANConnectionDevice 	 InternetGatewayDevice.WANDevice.1.WANConnectionDevice.1,	0	xsd:string
InternetGatewayDevice.WANDevice.1.WANDSLConnectionManagement.ConnectionService.1.WANConnectionService 	 InternetGatewayDevice.WANDevice.1.WANConnectionDevice.1.WANIPConnection.2,	0	xsd:string
InternetGatewayDevice.WANDevice.1.WANDSLConnectionManagement.ConnectionServiceNumberOfEntries 	1	0	xsd:unsignedInt
InternetGatewayDevice.WANDevice.1.WANDSLDiagnostics.ACTATPds 	0	0	xsd:int
InternetGatewayDevice.WANDevice.1.WANDSLDiagnostics.ACTATPus 	0	0	xsd:int
InternetGatewayDevice.WANDevice.1.WANDSLDiagnostics.ACTPSDds 	0	0	xsd:int
InternetGatewayDevice.WANDevice.1.WANDSLDiagnostics.ACTPSDus 	0	0	xsd:int
InternetGatewayDevice.WANDevice.1.WANDSLDiagnostics.BITSpsds 	 undef	0	xsd:string
InternetGatewayDevice.WANDevice.1.WANDSLDiagnostics.GAINSpsds 	 undef	0	xsd:string
InternetGatewayDevice.WANDevice.1.WANDSLDiagnostics.HLINpsds 	 undef	0	xsd:string
InternetGatewayDevice.WANDevice.1.WANDSLDiagnostics.HLINpsus 	 undef	0	xsd:string
InternetGatewayDevice.WANDevice.1.WANDSLDiagnostics.HLINSCds 	0	0	xsd:int
InternetGatewayDevice.WANDevice.1.WANDSLDiagnostics.HLINSCus 	0	0	xsd:int
InternetGatewayDevice.WANDevice.1.WANDSLDiagnostics.HLOGMTds 	256	0	xsd:unsignedInt
InternetGatewayDevice.WANDevice.1.WANDSLDiagnostics.HLOGMTus 	256	0	xsd:unsignedInt
InternetGatewayDevice.WANDevice.1.WANDSLDiagnostics.HLOGpsds 	 undef	0	xsd:string
InternetGatewayDevice.WANDevice.1.WANDSLDiagnostics.HLOGpsus 	 undef	0	xsd:string
InternetGatewayDevice.WANDevice.1.WANDSLDiagnostics.LATNpbds 	0	0	xsd:string
InternetGatewayDevice.WANDevice.1.WANDSLDiagnostics.LATNpbus 	0	0	xsd:string
InternetGatewayDevice.WANDevice.1.WANDSLDiagnostics.LoopDiagnosticsState 	 None	1	xsd:string
InternetGatewayDevice.WANDevice.1.WANDSLDiagnostics.QLNMTds 	128	0	xsd:unsignedInt
InternetGatewayDevice.WANDevice.1.WANDSLDiagnostics.QLNMTus 	128	0	xsd:unsignedInt
InternetGatewayDevice.WANDevice.1.WANDSLDiagnostics.QLNpsds 	 undef	0	xsd:string
InternetGatewayDevice.WANDevice.1.WANDSLDiagnostics.QLNpsus 	 undef	0	xsd:string
InternetGatewayDevice.WANDevice.1.WANDSLDiagnostics.SATNds 	0	0	xsd:string
InternetGatewayDevice.WANDevice.1.WANDSLDiagnostics.SATNus 	0	0	xsd:string
InternetGatewayDevice.WANDevice.1.WANDSLDiagnostics.SNRMTds 	512	0	xsd:unsignedInt
InternetGatewayDevice.WANDevice.1.WANDSLDiagnostics.SNRMTus 	512	0	xsd:unsignedInt
InternetGatewayDevice.WANDevice.1.WANDSLDiagnostics.SNRpsds 	 undef	0	xsd:string
InternetGatewayDevice.WANDevice.1.WANDSLDiagnostics.SNRpsus 	 undef	0	xsd:string
InternetGatewayDevice.WANDevice.1.WANDSLInterfaceConfig.ATUCCountry 	0	0	xsd:unsignedInt
InternetGatewayDevice.WANDevice.1.WANDSLInterfaceConfig.ATUCVendor 	 undef	0	xsd:string
InternetGatewayDevice.WANDevice.1.WANDSLInterfaceConfig.ATURCountry 	0	0	xsd:unsignedInt
InternetGatewayDevice.WANDevice.1.WANDSLInterfaceConfig.ATURVendor 	 undef	0	xsd:string
InternetGatewayDevice.WANDevice.1.WANDSLInterfaceConfig.DataPath 	 undef	0	xsd:string
InternetGatewayDevice.WANDevice.1.WANDSLInterfaceConfig.DownstreamAttenuation 	0	0	xsd:int
InternetGatewayDevice.WANDevice.1.WANDSLInterfaceConfig.DownstreamCurrRate 	0	0	xsd:unsignedInt
InternetGatewayDevice.WANDevice.1.WANDSLInterfaceConfig.DownstreamMaxRate 	0	0	xsd:unsignedInt
InternetGatewayDevice.WANDevice.1.WANDSLInterfaceConfig.DownstreamNoiseMargin 	0	0	xsd:int
InternetGatewayDevice.WANDevice.1.WANDSLInterfaceConfig.DownstreamPower 	0	0	xsd:int
InternetGatewayDevice.WANDevice.1.WANDSLInterfaceConfig.Enable 	1	1	xsd:boolean
InternetGatewayDevice.WANDevice.1.WANDSLInterfaceConfig.InterleaveDepth 	0	0	xsd:unsignedInt
InternetGatewayDevice.WANDevice.1.WANDSLInterfaceConfig.LineEncoding 	 DMT	0	xsd:string
InternetGatewayDevice.WANDevice.1.WANDSLInterfaceConfig.LinkEncapsulationRequested 	 undef	1	xsd:string
InternetGatewayDevice.WANDevice.1.WANDSLInterfaceConfig.LinkEncapsulationSupported 	 undef	0	xsd:string
InternetGatewayDevice.WANDevice.1.WANDSLInterfaceConfig.LinkEncapsulationUsed 	 undef	0	xsd:string
InternetGatewayDevice.WANDevice.1.WANDSLInterfaceConfig.ModulationType 	 undef	0	xsd:string
InternetGatewayDevice.WANDevice.1.WANDSLInterfaceConfig.ShowtimeStart 	0	0	xsd:unsignedInt
InternetGatewayDevice.WANDevice.1.WANDSLInterfaceConfig.StandardsSupported 	 undef	0	xsd:string
InternetGatewayDevice.WANDevice.1.WANDSLInterfaceConfig.StandardUsed 	 undef	0	xsd:string
InternetGatewayDevice.WANDevice.1.WANDSLInterfaceConfig.Stats.QuarterHour.ATUCCRCErrors 	0	0	xsd:unsignedInt
InternetGatewayDevice.WANDevice.1.WANDSLInterfaceConfig.Stats.QuarterHour.ATUCFECErrors 	0	0	xsd:unsignedInt
InternetGatewayDevice.WANDevice.1.WANDSLInterfaceConfig.Stats.QuarterHour.ATUCHECErrors 	0	0	xsd:unsignedInt
InternetGatewayDevice.WANDevice.1.WANDSLInterfaceConfig.Stats.QuarterHour.CellDelin 	0	0	xsd:unsignedInt
InternetGatewayDevice.WANDevice.1.WANDSLInterfaceConfig.Stats.QuarterHour.CRCErrors 	0	0	xsd:unsignedInt
InternetGatewayDevice.WANDevice.1.WANDSLInterfaceConfig.Stats.QuarterHour.ErroredSecs 	0	0	xsd:unsignedInt
InternetGatewayDevice.WANDevice.1.WANDSLInterfaceConfig.Stats.QuarterHour.FECErrors 	0	0	xsd:unsignedInt
InternetGatewayDevice.WANDevice.1.WANDSLInterfaceConfig.Stats.QuarterHour.HECErrors 	0	0	xsd:unsignedInt
InternetGatewayDevice.WANDevice.1.WANDSLInterfaceConfig.Stats.QuarterHour.InitErrors 	0	0	xsd:unsignedInt
InternetGatewayDevice.WANDevice.1.WANDSLInterfaceConfig.Stats.QuarterHour.InitTimeouts 	0	0	xsd:unsignedInt
InternetGatewayDevice.WANDevice.1.WANDSLInterfaceConfig.Stats.QuarterHour.LinkRetrain 	0	0	xsd:unsignedInt
InternetGatewayDevice.WANDevice.1.WANDSLInterfaceConfig.Stats.QuarterHour.LossOfFraming 	0	0	xsd:unsignedInt
InternetGatewayDevice.WANDevice.1.WANDSLInterfaceConfig.Stats.QuarterHour.ReceiveBlocks 	0	0	xsd:unsignedInt
InternetGatewayDevice.WANDevice.1.WANDSLInterfaceConfig.Stats.QuarterHour.SeverelyErroredSecs 	0	0	xsd:unsignedInt
InternetGatewayDevice.WANDevice.1.WANDSLInterfaceConfig.Stats.QuarterHour.TransmitBlocks 	0	0	xsd:unsignedInt
InternetGatewayDevice.WANDevice.1.WANDSLInterfaceConfig.Stats.Showtime.ATUCCRCErrors 	0	0	xsd:unsignedInt
InternetGatewayDevice.WANDevice.1.WANDSLInterfaceConfig.Stats.Showtime.ATUCFECErrors 	0	0	xsd:unsignedInt
InternetGatewayDevice.WANDevice.1.WANDSLInterfaceConfig.Stats.Showtime.ATUCHECErrors 	0	0	xsd:unsignedInt
InternetGatewayDevice.WANDevice.1.WANDSLInterfaceConfig.Stats.Showtime.CellDelin 	0	0	xsd:unsignedInt
InternetGatewayDevice.WANDevice.1.WANDSLInterfaceConfig.Stats.Showtime.CRCErrors 	0	0	xsd:unsignedInt
InternetGatewayDevice.WANDevice.1.WANDSLInterfaceConfig.Stats.Showtime.ErroredSecs 	0	0	xsd:unsignedInt
InternetGatewayDevice.WANDevice.1.WANDSLInterfaceConfig.Stats.Showtime.FECErrors 	0	0	xsd:unsignedInt
InternetGatewayDevice.WANDevice.1.WANDSLInterfaceConfig.Stats.Showtime.HECErrors 	0	0	xsd:unsignedInt
InternetGatewayDevice.WANDevice.1.WANDSLInterfaceConfig.Stats.Showtime.InitErrors 	0	0	xsd:unsignedInt
InternetGatewayDevice.WANDevice.1.WANDSLInterfaceConfig.Stats.Showtime.InitTimeouts 	0	0	xsd:unsignedInt
InternetGatewayDevice.WANDevice.1.WANDSLInterfaceConfig.Stats.Showtime.LinkRetrain 	0	0	xsd:unsignedInt
InternetGatewayDevice.WANDevice.1.WANDSLInterfaceConfig.Stats.Showtime.LossOfFraming 	0	0	xsd:unsignedInt
InternetGatewayDevice.WANDevice.1.WANDSLInterfaceConfig.Stats.Showtime.ReceiveBlocks 	0	0	xsd:unsignedInt
InternetGatewayDevice.WANDevice.1.WANDSLInterfaceConfig.Stats.Showtime.SeverelyErroredSecs 	0	0	xsd:unsignedInt
InternetGatewayDevice.WANDevice.1.WANDSLInterfaceConfig.Stats.Showtime.TransmitBlocks 	0	0	xsd:unsignedInt
InternetGatewayDevice.WANDevice.1.WANDSLInterfaceConfig.Stats.Total.ATUCCRCErrors 	0	0	xsd:unsignedInt
InternetGatewayDevice.WANDevice.1.WANDSLInterfaceConfig.Stats.Total.ATUCFECErrors 	0	0	xsd:unsignedInt
InternetGatewayDevice.WANDevice.1.WANDSLInterfaceConfig.Stats.Total.ATUCHECErrors 	0	0	xsd:unsignedInt
InternetGatewayDevice.WANDevice.1.WANDSLInterfaceConfig.Stats.Total.CellDelin 	0	0	xsd:unsignedInt
InternetGatewayDevice.WANDevice.1.WANDSLInterfaceConfig.Stats.Total.CRCErrors 	0	0	xsd:unsignedInt
InternetGatewayDevice.WANDevice.1.WANDSLInterfaceConfig.Stats.Total.ErroredSecs 	0	0	xsd:unsignedInt
InternetGatewayDevice.WANDevice.1.WANDSLInterfaceConfig.Stats.Total.FECErrors 	0	0	xsd:unsignedInt
InternetGatewayDevice.WANDevice.1.WANDSLInterfaceConfig.Stats.Total.HECErrors 	0	0	xsd:unsignedInt
InternetGatewayDevice.WANDevice.1.WANDSLInterfaceConfig.Stats.Total.InitErrors 	0	0	xsd:unsignedInt
InternetGatewayDevice.WANDevice.1.WANDSLInterfaceConfig.Stats.Total.InitTimeouts 	0	0	xsd:unsignedInt
InternetGatewayDevice.WANDevice.1.WANDSLInterfaceConfig.Stats.Total.LinkRetrain 	0	0	xsd:unsignedInt
InternetGatewayDevice.WANDevice.1.WANDSLInterfaceConfig.Stats.Total.LossOfFraming 	0	0	xsd:unsignedInt
InternetGatewayDevice.WANDevice.1.WANDSLInterfaceConfig.Stats.Total.ReceiveBlocks 	0	0	xsd:unsignedInt
InternetGatewayDevice.WANDevice.1.WANDSLInterfaceConfig.Stats.Total.SeverelyErroredSecs 	0	0	xsd:unsignedInt
InternetGatewayDevice.WANDevice.1.WANDSLInterfaceConfig.Stats.Total.TransmitBlocks 	0	0	xsd:unsignedInt
InternetGatewayDevice.WANDevice.1.WANDSLInterfaceConfig.Status 	 Down	0	xsd:string
InternetGatewayDevice.WANDevice.1.WANDSLInterfaceConfig.TestParams.HLOGMTds 	256	0	xsd:unsignedInt
InternetGatewayDevice.WANDevice.1.WANDSLInterfaceConfig.TestParams.HLOGMTus 	256	0	xsd:unsignedInt
InternetGatewayDevice.WANDevice.1.WANDSLInterfaceConfig.TestParams.HLOGpsds 	 undef	0	xsd:string
InternetGatewayDevice.WANDevice.1.WANDSLInterfaceConfig.TestParams.HLOGpsus 	 undef	0	xsd:string
InternetGatewayDevice.WANDevice.1.WANDSLInterfaceConfig.TestParams.LATNds 	0	0	xsd:string
InternetGatewayDevice.WANDevice.1.WANDSLInterfaceConfig.TestParams.LATNus 	0	0	xsd:string
InternetGatewayDevice.WANDevice.1.WANDSLInterfaceConfig.TestParams.QLNMTds 	128	0	xsd:unsignedInt
InternetGatewayDevice.WANDevice.1.WANDSLInterfaceConfig.TestParams.QLNMTus 	128	0	xsd:unsignedInt
InternetGatewayDevice.WANDevice.1.WANDSLInterfaceConfig.TestParams.QLNpsds 	 undef	0	xsd:string
InternetGatewayDevice.WANDevice.1.WANDSLInterfaceConfig.TestParams.QLNpsus 	 undef	0	xsd:string
InternetGatewayDevice.WANDevice.1.WANDSLInterfaceConfig.TestParams.SATNds 	0	0	xsd:string
InternetGatewayDevice.WANDevice.1.WANDSLInterfaceConfig.TestParams.SATNus 	0	0	xsd:string
InternetGatewayDevice.WANDevice.1.WANDSLInterfaceConfig.TestParams.SNRMTds 	512	0	xsd:unsignedInt
InternetGatewayDevice.WANDevice.1.WANDSLInterfaceConfig.TestParams.SNRMTus 	512	0	xsd:unsignedInt
InternetGatewayDevice.WANDevice.1.WANDSLInterfaceConfig.TestParams.SNRpsds 	 undef	0	xsd:string
InternetGatewayDevice.WANDevice.1.WANDSLInterfaceConfig.TestParams.SNRpsus 	 undef	0	xsd:string
InternetGatewayDevice.WANDevice.1.WANDSLInterfaceConfig.TotalStart 	4786	0	xsd:unsignedInt
InternetGatewayDevice.WANDevice.1.WANDSLInterfaceConfig.UpstreamAttenuation 	0	0	xsd:int
InternetGatewayDevice.WANDevice.1.WANDSLInterfaceConfig.UpstreamCurrRate 	0	0	xsd:unsignedInt
InternetGatewayDevice.WANDevice.1.WANDSLInterfaceConfig.UpstreamMaxRate 	0	0	xsd:unsignedInt
InternetGatewayDevice.WANDevice.1.WANDSLInterfaceConfig.UpstreamNoiseMargin 	0	0	xsd:int
InternetGatewayDevice.WANDevice.1.WANDSLInterfaceConfig.UpstreamPower 	0	0	xsd:int
InternetGatewayDevice.WANDevice.2.WANCommonInterfaceConfig.EnabledForInternet 	1	1	xsd:boolean
InternetGatewayDevice.WANDevice.2.WANCommonInterfaceConfig.Layer1DownstreamMaxBitRate 	100000000	0	xsd:unsignedInt
InternetGatewayDevice.WANDevice.2.WANCommonInterfaceConfig.Layer1UpstreamMaxBitRate 	100000000	0	xsd:unsignedInt
InternetGatewayDevice.WANDevice.2.WANCommonInterfaceConfig.MaximumActiveConnections 	8	0	xsd:unsignedInt
InternetGatewayDevice.WANDevice.2.WANCommonInterfaceConfig.NumberOfActiveConnections 	1	0	xsd:unsignedInt
InternetGatewayDevice.WANDevice.2.WANCommonInterfaceConfig.PhysicalLinkStatus 	 Up	0	xsd:string
InternetGatewayDevice.WANDevice.2.WANCommonInterfaceConfig.TotalBytesReceived 	71875	0	xsd:unsignedInt
InternetGatewayDevice.WANDevice.2.WANCommonInterfaceConfig.TotalBytesSent 	265402	0	xsd:unsignedInt
InternetGatewayDevice.WANDevice.2.WANCommonInterfaceConfig.TotalPacketsReceived 	997	0	xsd:unsignedInt
InternetGatewayDevice.WANDevice.2.WANCommonInterfaceConfig.TotalPacketsSent 	951	0	xsd:unsignedInt
InternetGatewayDevice.WANDevice.2.WANCommonInterfaceConfig.WANAccessProvider 	 undef	0	xsd:string
InternetGatewayDevice.WANDevice.2.WANCommonInterfaceConfig.WANAccessType 	 Ethernet	0	xsd:string
InternetGatewayDevice.WANDevice.2.WANConnectionDevice.1.WANEthernetLinkConfig.EthernetLinkStatus 	 Up	0	xsd:string
InternetGatewayDevice.WANDevice.2.WANConnectionDevice.1.WANIPConnection.2.AddressingType 	 Static	1	xsd:string
InternetGatewayDevice.WANDevice.2.WANConnectionDevice.1.WANIPConnection.2.ConnectionStatus 	 Connected	0	xsd:string
InternetGatewayDevice.WANDevice.2.WANConnectionDevice.1.WANIPConnection.2.ConnectionTrigger 	 AlwaysOn	1	xsd:string
InternetGatewayDevice.WANDevice.2.WANConnectionDevice.1.WANIPConnection.2.ConnectionType 	 IP_Routed	1	xsd:string
InternetGatewayDevice.WANDevice.2.WANConnectionDevice.1.WANIPConnection.2.DefaultGateway 	 192.168.11.1	1	xsd:string
InternetGatewayDevice.WANDevice.2.WANConnectionDevice.1.WANIPConnection.2.DHCPClient.ReqDHCPOptionNumberOfEntries 	0	0	xsd:unsignedInt
InternetGatewayDevice.WANDevice.2.WANConnectionDevice.1.WANIPConnection.2.DHCPClient.SentDHCPOptionNumberOfEntries 	0	0	xsd:unsignedInt
InternetGatewayDevice.WANDevice.2.WANConnectionDevice.1.WANIPConnection.2.DNSEnabled 	1	1	xsd:boolean
InternetGatewayDevice.WANDevice.2.WANConnectionDevice.1.WANIPConnection.2.DNSOverrideAllowed 	1	1	xsd:boolean
InternetGatewayDevice.WANDevice.2.WANConnectionDevice.1.WANIPConnection.2.DNSServers 	 undef	1	xsd:string
InternetGatewayDevice.WANDevice.2.WANConnectionDevice.1.WANIPConnection.2.Enable 	1	1	xsd:boolean
InternetGatewayDevice.WANDevice.2.WANConnectionDevice.1.WANIPConnection.2.ExternalIPAddress 	 192.168.11.4	1	xsd:string
InternetGatewayDevice.WANDevice.2.WANConnectionDevice.1.WANIPConnection.2.LastConnectionError 	 ERROR_NONE	0	xsd:string
InternetGatewayDevice.WANDevice.2.WANConnectionDevice.1.WANIPConnection.2.MACAddress 	 8C:10:D4:30:FF:7A	0	xsd:string
InternetGatewayDevice.WANDevice.2.WANConnectionDevice.1.WANIPConnection.2.MaxMTUSize 	1500	1	xsd:unsignedInt
InternetGatewayDevice.WANDevice.2.WANConnectionDevice.1.WANIPConnection.2.Name 	 a0	1	xsd:string
InternetGatewayDevice.WANDevice.2.WANConnectionDevice.1.WANIPConnection.2.NATEnabled 	1	1	xsd:boolean
InternetGatewayDevice.WANDevice.2.WANConnectionDevice.1.WANIPConnection.2.PortMappingNumberOfEntries 	0	0	xsd:unsignedInt
InternetGatewayDevice.WANDevice.2.WANConnectionDevice.1.WANIPConnection.2.PossibleConnectionTypes 	 IP_Routed,IP_Bridged	0	xsd:string
InternetGatewayDevice.WANDevice.2.WANConnectionDevice.1.WANIPConnection.2.Reset 	0	1	xsd:boolean
InternetGatewayDevice.WANDevice.2.WANConnectionDevice.1.WANIPConnection.2.RouteProtocolRx 	 Off	1	xsd:string
InternetGatewayDevice.WANDevice.2.WANConnectionDevice.1.WANIPConnection.2.RSIPAvailable 	0	0	xsd:boolean
InternetGatewayDevice.WANDevice.2.WANConnectionDevice.1.WANIPConnection.2.Stats.EthernetBroadcastPacketsReceived 	0	0	xsd:unsignedInt
InternetGatewayDevice.WANDevice.2.WANConnectionDevice.1.WANIPConnection.2.Stats.EthernetBroadcastPacketsSent 	0	0	xsd:unsignedInt
InternetGatewayDevice.WANDevice.2.WANConnectionDevice.1.WANIPConnection.2.Stats.EthernetBytesReceived 	71875	0	xsd:unsignedInt
InternetGatewayDevice.WANDevice.2.WANConnectionDevice.1.WANIPConnection.2.Stats.EthernetBytesSent 	265402	0	xsd:unsignedInt
InternetGatewayDevice.WANDevice.2.WANConnectionDevice.1.WANIPConnection.2.Stats.EthernetDiscardPacketsReceived 	0	0	xsd:unsignedInt
InternetGatewayDevice.WANDevice.2.WANConnectionDevice.1.WANIPConnection.2.Stats.EthernetDiscardPacketsSent 	0	0	xsd:unsignedInt
InternetGatewayDevice.WANDevice.2.WANConnectionDevice.1.WANIPConnection.2.Stats.EthernetErrorsReceived 	0	0	xsd:unsignedInt
InternetGatewayDevice.WANDevice.2.WANConnectionDevice.1.WANIPConnection.2.Stats.EthernetErrorsSent 	0	0	xsd:unsignedInt
InternetGatewayDevice.WANDevice.2.WANConnectionDevice.1.WANIPConnection.2.Stats.EthernetMulticastPacketsReceived 	0	0	xsd:unsignedInt
InternetGatewayDevice.WANDevice.2.WANConnectionDevice.1.WANIPConnection.2.Stats.EthernetMulticastPacketsSent 	0	0	xsd:unsignedInt
InternetGatewayDevice.WANDevice.2.WANConnectionDevice.1.WANIPConnection.2.Stats.EthernetPacketsReceived 	997	0	xsd:unsignedInt
InternetGatewayDevice.WANDevice.2.WANConnectionDevice.1.WANIPConnection.2.Stats.EthernetPacketsSent 	951	0	xsd:unsignedInt
InternetGatewayDevice.WANDevice.2.WANConnectionDevice.1.WANIPConnection.2.Stats.EthernetUnicastPacketsReceived 	997	0	xsd:unsignedInt
InternetGatewayDevice.WANDevice.2.WANConnectionDevice.1.WANIPConnection.2.Stats.EthernetUnicastPacketsSent 	951	0	xsd:unsignedInt
InternetGatewayDevice.WANDevice.2.WANConnectionDevice.1.WANIPConnection.2.Stats.EthernetUnknownProtoPacketsReceived 	0	0	xsd:unsignedInt
InternetGatewayDevice.WANDevice.2.WANConnectionDevice.1.WANIPConnection.2.SubnetMask 	 255.255.255.0	1	xsd:string
InternetGatewayDevice.WANDevice.2.WANConnectionDevice.1.WANIPConnection.2.Uptime 	4786	0	xsd:unsignedInt
InternetGatewayDevice.WANDevice.2.WANConnectionDevice.1.WANIPConnectionNumberOfEntries 	1	0	xsd:unsignedInt
InternetGatewayDevice.WANDevice.2.WANConnectionDevice.1.WANPPPConnectionNumberOfEntries 	0	0	xsd:unsignedInt
InternetGatewayDevice.WANDevice.2.WANConnectionNumberOfEntries 	1	0	xsd:unsignedInt
InternetGatewayDevice.WANDevice.2.WANEthernetInterfaceConfig.DuplexMode 	 Auto	1	xsd:string
InternetGatewayDevice.WANDevice.2.WANEthernetInterfaceConfig.Enable 	1	1	xsd:boolean
InternetGatewayDevice.WANDevice.2.WANEthernetInterfaceConfig.MACAddress 	 8C:10:D4:30:FF:7A	0	xsd:string
InternetGatewayDevice.WANDevice.2.WANEthernetInterfaceConfig.MaxBitRate 	 Auto	1	xsd:string
InternetGatewayDevice.WANDevice.2.WANEthernetInterfaceConfig.Stats.BytesReceived 	71875	0	xsd:unsignedInt
InternetGatewayDevice.WANDevice.2.WANEthernetInterfaceConfig.Stats.BytesSent 	265402	0	xsd:unsignedInt
InternetGatewayDevice.WANDevice.2.WANEthernetInterfaceConfig.Stats.PacketsReceived 	997	0	xsd:unsignedInt
InternetGatewayDevice.WANDevice.2.WANEthernetInterfaceConfig.Stats.PacketsSent 	951	0	xsd:unsignedInt
InternetGatewayDevice.WANDevice.2.WANEthernetInterfaceConfig.Status 	 Up	0	xsd:string
InternetGatewayDevice.WANDeviceNumberOfEntries 	1	0	xsd:unsignedInt
